In che modo è possibile aggiungere un dipendente frontline a Workplace?	Cosa sono i Messaggi Diretti?	False
Come è calcolato il prezzo di una prenotazione?	Si può guidare l’auto mentre è in corso un aggiornamento software?	False
Perché non riesco ad accedere all'app Tesla dopo la consegna?	Cosa devo fare prima di effettuare il rimessaggio della mia Yamaha?	False
Cosa si intende per utente al mese?	Come si attivano e usano i comandi vocali?	False
Sono un cliente attuale di Workplace Premium. Quali sono le conseguenze per me?	Essendo io un cliente Workplace Premium, quali potrebbero essere le possibili conseguenze per me?	True
I clienti possono lasciare feedback e perché è importante il feedback clienti?	Quali vantaggi fornisce un account My Ryanair?	False
Posso utilizzare il coupon per acquistare qualsiasi oggetto?	Quale è il carico massimo consentito per il mio veicolo?	False
Che informazioni vengono richieste in fase di registrazione?	Quali dati devo inserire per l'iscrizione?	True
Che cos’è un posto con 'vista limitata'?	Cosa significa che un posto ha 'vista limitata'?	True
Dove dovrei posizionare un eventuale transponder / telepass?	Dove metto il transponder / telepass?	True
Cosa devo fare prima di effettuare il rimessaggio della mia Yamaha?	Ci sono delle operazioni che devo effettuare prima di lasciare la mia moto ferma per molto tempo?	True
Cos'è Vendita su Amazon?	Cosa ottengo in cambio della commissione che pago?	False
Cosa comporta avere un posto con 'vista limitata'?	Lo spettacolo può essere registrato o fotografato?	False
Come posso sapere chi sto seguendo?	Vorrei una lista delle persone che seguo, dove devo andare?	True
Quali articoli non posso vendere su Amazon.it?	Quali sono i prodotti proibiti su Amazon.it?	True
Come posso confermare la mia prenotazione?	Come faccio a dare la conferma di una prenotazione?	True
Come cancello una prenotazione?	La prenotazione può essere cancellata?	True
Di quali informazioni ho bisogno per l'iscrizione?	Che informazioni vengono richieste in fase di registrazione?	True
Cosa significa per utente al mese?	I biglietti sono prenotati con il mio nome. Posso cambiare il nome del viaggiatore principale?	False
Come faccio a eliminare il mio account?	Cosa succdede se ho un annuncio online in una categoria attrezzature di lavoro?	False
Esiste il rischio che qualcuno condivida contenuti dal suo account Facebook personale su Workplace?	é possibile condividere contenuti da un’account Facebook personale su Workplace?	True
Chi stabilisce il prezzo di vendita per la mia prenotazione?	Chi decide il prezzo della mia prenotazione?	True
Quanto costa la funzione per il lavoro frontline?	Qual è l’ubicazione dei vostri data center?	False
Non ho utilizzato il valore totale del mio Voucher di Viaggio per la mia mia prenotazione. Posso utilizzare il saldo rimanente?	Il saldo rimanente di un voucher di viaggio può essere riutilizzato in un'altra prenotazione?	True
Dove trovo le informazioni dettagliate sul mio tour?	Dove trovo le informazioni utili su tour e attrazioni?	True
I clienti possono lasciare feedback e perché è importante il feedback clienti?	I clienti possono lasciare recensioni e che impatto ha questo feedback?	True
Chi possiede e controlla le informazioni create dai dipendenti della mia organizzazione?	Chi ha il monopolio delle informazioni inserite dai dipendenti della mia organizzazione?	True
Vi è disponibilità immediata sul mio tolino degli acquisti effettuati su LaFeltrinelli Internet Bookshop SRL?	Per quanto tempo sono coperto dalla polizza assicurativa?	False
Per quale motivo è necessaria la registrazione del mio tolino	"È possibile cancellare o modificare le date di una prenotazione ""non rimborsabile""?"	False
Sono presenti inserzioni su Workplace?	Dove dovrei posizionare un eventuale transponder / telepass?	False
Come posso fare il check-in fuori dall'orario prestabilito?	Come si attiva l’opzione Summon?	False
Chi esegue l'addebito sulla mia carta?	La mia carta da chi viene addebitata?	True
È necessario creare un account Facebook personale per usare Workplace?	Per usufruire di Workplace serve un account Facebook?	True
Ho sbagliato a digitare la mail e/o il numero di cellulare in fase di registrazione al sito	Come posso comportarmi nel caso in cui non avessi un accuout LaFeltrinelli Internet Bookshop SRL?	False
A che ora devo presentarmi alla partita?	Come posso essere certo che il mio annuncio venga pubblicato?	False
Come è calcolato il prezzo di una prenotazione?	Quali informazioni dovrei portare con me per entrare nell'attrazione?	False
Una volta passata a un piano diverso, la mia organizzazione perderà i dati presenti su Workplace?	Dove posso consultare gli orari di check-in e check-out dell'albergo prenotato?	False
Come mi registro per vendere prodotti su Amazon.it?	Come mi registro come venditore su Amazon.it?	True
In che modo Workplace protegge le mie informazioni?	Che tipo di manutenzione richiede la mia nuova Tesla?	False
Quali sono i vantaggi di un account My Ryanair?	Posso continuare a inserire in categoria attrezzature di lavoro?	False
Che tipo di manutenzione richiede la mia nuova Tesla?	Che manutenzione devo effettuare sulla mia nuova Tesla?	True
E' possibile aggiungere coperutre addizionali alla polizza di assicurazione?	È possibile includere nella polizza una condizione medica precedente?	True
Esiste il rischio che qualcuno condivida contenuti dal suo account Facebook personale su Workplace?	I dati che ho inserito sono protetti?	False
Devo preoccuparmi se ho delle inserzioni attive in attrezzature da lavoro?	Non riesco ad iniziare a seguire le persone, mi aiutate?	False
Come posso registrarmi?	Come ci si registra?	True
Cosa succede dopo aver salvato una ricerca?	Cosa succede se tento di salvare una ricerca, sarò in grado di poterla visualizzare più avanti?	True
A cosa serve Vendita su Amazon?	Cos'è la nuova 'Carta a Scalare'?	False
Cos'è Workplace di Facebook?	Di cosa tratta il servizio Workplace di Facebook?	True
Come posso inserire i prodotto che devo vendere su Amazon?	Come metto i prodotti in vendita su Amazon?	True
Posso registrare o fare foto allo spettacolo?	Come sono variate le tariffe con l'introduzione del sistema MITT?	False
Come è calcolato il prezzo di una prenotazione?	Dove dovrei posizionare un eventuale transponder / telepass?	False
Come posso ricevere una fattura?	Come si ottiene una fattura per il soggiorno?	True
Cos'è Workplace Essential?	Come posso dare accesso all’app ai miei famigliari?	False
Come vengo protetto dalle frodi?	Quanti e quali liquidi è consentito trasportare nel bagaglio a mano?	False
Parto per gli Stati Uniti d'America. Che cos'è il programma Visa Waiver Program?	Qual'è la differenza tra Platea e Galleria?	False
Chi decide il prezzo della mia prenotazione?	Come posso accedere agli aggiornamenti software e quanto tempo richiedono?	False
Perchè solo ad alcune pagine è stata modifica la grafica?	Cosa sono le risposte?	False
Posso acquistare e scaricare i miei ebook direttamente sul lettore mentre mi trovo all'estero?	Nel caso in cui mi trovi all’estero, è possibile acquistare e scaricare gli ebook diretrtamente sul lettore?	True
Come posso usare il gancio traino con la mia auto?	Quale è la procedura di uso del traino della mia auto?	True
Quali posti sono considerati i migliori?	Quali sono i migliori posti?	True
Quale metodo di spedizione viene utilizzato?	Per quale motivo la mia azienda pagherebbe per avere un servizio da Workplace Advanced e Workplace Enterprise se comunque molte funzionalità sono già presenti su Facebook e Workplace Essential?	False
Come si può confermare una prenotazione?	Come si conferma una prenotazione?	True
Come si crea un Adobe ID?	Si può disabilitare il touchscreen?	False
è possibile usare Workplace anche se soggetti a requisiti di elaborazione dei dati dell’Unione eurpoea?	Il mio account è stato bloccato e non riesco più ad accedervi, come faccio?	False
Dove si trovano i vostri data center?	Qual è l’ubicazione dei vostri data center?	True
Dovrò effettuare l'accesso ogni volta che prenoto un volo?	È necessario accedere all'account per prenotare un volo?	True
Ho prenotato una fascia oraria, a che ora devo arrivare?	Ho prenotato un tour per una fascia oraria, a che ora devo presentarmi?	True
Mi è arrivato un link tramite email, che cosa devo fare?	Come funzionano i comandi vocali?	False
Cosa posso fare se resto chiuso fuori dal veicolo?	C’e’ un modo per entrare nella mia auto in caso resti chiuso fuori?	True
Parto per un Paese che non appartiene alla Comunità Europea. Basta la carta d'identità ?	Serve il passaporto per andare in paesi non appartenenti all'UE?	True
Cosa devo sapere sulla guida alle basse temperature?	Quali sono gli aspetti principali sulla guida alle basse temperature?	True
Quali articoli posso vendere su Amazon.it?	Cosa posso vendere su Amazon.it?	True
È necessario creare un account Facebook personale per usare Workplace?	Anche il mio profilo cambiato?	False
Ci sono costi aggiuntivi per i bambini?	Sono previsti costi addizionali per i bambini?	True
Qual'è la differenza tra obliterazione e validazione?	Non capisco la differenza che c'è tra obliterare e validare in mio biglietto, potreste spiegarmela?	True
Mi verrà addebitato il pagamento se annullo la prenotazione?	Devo comunque pagare se annullo una prenotazione?	True
Servono ulteriori documenti per viaggiare in paesi non UE?	Serve il passaporto per andare in paesi non appartenenti all'UE?	True
La mia scuola mi ha dato una lista di libri da comprare, come posso prenotarli?	Dovrò effettuare l'accesso ogni volta che prenoto un volo?	False
è possibile iscriversi unicamente per la funzione di lavoro frontline?	Come posso recuperare tutte le informazioni sui Termini di partecipazione a Twitter?	False
Come posso avere chiavi di riserva o duplicati per la mia Yamaha?	A chi devo rivolgermi per fare una copia della chiave della mia moto?	True
Vuoi un suggerimento per evitare che il tuo annuncio venga rifiutato?	Chi devo contattare per notificare il mio cambio di domicilio?	False
Come posso inserire i prodotto che devo vendere su Amazon?	Posso ricevere informazioni sulla camera da me prenotata?	False
Cosa succede se una partita per la quale ho acquistato i biglietti è stata cancellata?	Cosa succede in caso di cancellazione di una partita?	True
Quali sono i regolamenti e il codice di condotta della sede?	Dove trovo il codice di condotta e i regolamenti della sede?	True
Di cosa tratta il servizio Workplace di Facebook?	C’è pubblicità su Workplace?	False
Posso apportare modifiche alla mia prenotazione?	Si può modificare una prenotazione?	True
I biglietti prevedono posti contigui?	Cosa succede se una partita per cui ho acquistato i biglietti è stata posticipata o la data/ora è cambiata?	False
Cos'è la funzione per il lavoro frontline di Workplace?	Per usufruire di Workplace serve un account Facebook?	False
Cos'è Workplace Enterprise?	In cosa consiste Workplace Enterprise?	True
	Cosa succede quando un dipendente non lavora più nell'azienda?	False
Cosa succede se un ospite arreca dei danni alla struttura?	Gli ospiti hanno rovinato la camera. Cosa si puo' fare?	True
Quando saranno disponibili i nuovi piani?	In che tempistichesatanno disponibili I nuovi piani	True
I coupon hanno una data di scadenza?	Come si attiva l’opzione Summon?	False
Durante il volo posso consumare cibo portato da casa?	Come posso ricevere una fattura?	False
Sapró se un acquirente ha utilizzato un coupon per il pagamento?	Come posso sapere se gli acquirenti uttilizzano coupon?	True
Il mio volo è stato annullato e non ho ricevuto l’email con il voucher di viaggio. Quando lo riceverò?	Quali sono i tempi previsti per la ricezione di un voucher di viaggio dopo l'annullamento del volo?	True
Come viene erogata assistenza medica in viaggio?	Vuoi un suggerimento per evitare che il tuo annuncio venga rifiutato?	False
Che cos’è un posto con 'vista limitata'?	Cosa comporta avere un posto con 'vista limitata'?	True
Qual è l’ubicazione dei vostri data center?	Posso modificare un Tweet dopo averlo pubblicato?	False
Che cos'è una cancellazione 'non rimborsabile' o 'cancellazione gratuita'?	Posso utilizzare più di un voucher di viaggio in una determinata prenotazione?	False
	È possibile portare cibo a bordo?	False
Posso registrare o fare foto allo spettacolo?	Lo spettacolo può essere registrato o fotografato?	True
Posso cancellare il mio abbonamento?	Che vantaggi ha il venditore accettando coupon?	False
Come posso inviare gli aggiornamenti su Twitter?	Vorrei notificare dei miei amici riguardo l'aggiornamento del profilo, come faccio?	True
Cosa mi serve per iscrivermi come venditore su Amazon?	Che documenti devo presentare per vedere la partita?	False
Chi addebiterà la mia carta?	La mia carta da chi viene addebitata?	True
Ho eliminato l'email ricevuta contenente il voucher di viaggio, come faccio a scoprire quale è il mio codice voucher univoco?	Dove posso reperire il codice del voucher dopo aver eliminato la mail ricevuta?	True
Cos'è un ereader?	In che cosa consiste un ereader?	True
In che modo è possibile prevedere il costo di Workplace in base al prezzo per utente al mese?	Come posso preventivare il costo di Workplace conoscendo il presso utente al mese?	True
Una volta modificato l'annuncio cosa succede?	Cosa succede se modifico un annuncio dal mio profilo Subito?	True
Cos'è Workplace Essential?	In cosa consiste Workplace Essential?	True
Per gli interventi in garanzia devo riportare il mio veicolo Yamaha dallo stesso concessionario presso il quale l'ho acquistato?	Nel caso dovessi avvalermi della garanzia sul veicolo, in quale concessionaria dovrei recarmi?	True
Quali documenti devo portare per viaggiare verso gli USA?	Dopo che ho compilato il modulo cosa faccio?	False
Mi imbarco per una destinazione internazionale. Quante valigie posso portare? Di che peso?	Qual'è il numero di bagagli consentito per un volo internazionale? E quale peso massimo?	True
La mia carta è stata addebitata e non ho ancora soggiornato.	Ho ricevuto un addebito nonostante non abbia ancora soggiornato.	True
Posso cedere un coupon o utilizzare quello di qualcun altro?	Una volta passata a un piano diverso, la mia organizzazione perderà i dati presenti su Workplace?	False
Quali saranno le conseguenze di questo cambiamento per i clienti di Workplace nelle Filippine, in Indonesia, in Nuova Zelanda, a Singapore e a Hong Kong?	Che potenziali effetti possono arrecare queste modifiche per i clienti di Workplace nelle Filippine, in Indonesia, in Nuova Zelanda, a Singapore e a Hong Kong?	True
Posso offrire confezioni regalo e biglietti di auguri ai miei clienti su Amazon.it?	Posso offrire confezioni regalo ai miei clienti su Amazon?	True
Va bene un immagine qualsiasi?	Desideri ricevere via email una lista di suggerimenti per migliorare il tuo annuncio?	False
Dove sono punzonate le matricole del telaio e del motore?	Come posso trovare il numero di telaio e il codice identificativo del motore della mia Yamaha?	True
Cosa succede dopo la registrazione?	Ho fatto la registrazione. E ora?	True
Devo essere un utente eBay per utilizzare il coupon?	Solo gli utenti eBay possono utilizzare coupon?	True
Siete in possesso di una certificazione SOC?	Serve un  abbigliamento particolare per prendere parte ad un tour?	False
Come utilizzo il codice indicato sul coupon?	Si può modificare una prenotazione?	False
Con l'introduzione del sistema MITT le tariffe sono aumentate?	Come sono variate le tariffe con l'introduzione del sistema MITT?	True
Gli acquisti effettuati su LaFeltrinelli Internet Bookshop SRL saranno a mia disposizione immediatamente anche nel mio tolino?	Vi è disponibilità immediata sul mio tolino degli acquisti effettuati su LaFeltrinelli Internet Bookshop SRL?	True
Quando e dove devo fare la revisione del mio veicolo?	Vorrei avere maggiori informazioni sulle scadenze della manutenzione e della revisione del mio veicolo.	True
Cos'è Workplace Essential?	Devo evitare di mettere alcuni oggetti nel bagaglio da stiva?	False
Ho prenotato il mio volo tramite un agente di viaggio. Come faccio a ricevere il mio voucher di viaggio?	Come funzionano i comandi vocali?	False
Che potenziali effetti possono arrecare queste modifiche per i clienti di Workplace nelle Filippine, in Indonesia, in Nuova Zelanda, a Singapore e a Hong Kong?	Posso ottenere un documento di conferma del ritardo di più di 3 ore valido per fini assicurativi?	False
Mi piacerebbe provare Workplace.	Un neonato ha diritto al voucher di viaggio nel caso di annullamento della prenotazione?	False
Cosa posso fare se perdo le chiavi?	A chi devo rivolgermi per fare una copia della chiave della mia moto?	False
Come ci si registra?	Mi saprebbe dare più informazione sul Model 3?	False
C'è la possibilità di annullare un ordine di libri già pagati?	Nel caso dovessi avvalermi della garanzia sul veicolo, in quale concessionaria dovrei recarmi?	False
C’è un termine per l’utilizzo del coupon?	I coupon hanno una data di scadenza?	True
Parto per gli Stati Uniti d'America. Quali documenti sono necessari per la partenza?	Quali documenti devo portare per viaggiare verso gli USA?	True
Come posso ottenere informazioni sulla camera o sui servizi della struttura?	Posso ricevere informazioni sulla camera da me prenotata?	True
Chi posso contattare in caso di problemi?	Qual'è il punto di contatto in caso di problemi?	True
Quali articoli non posso vendere su Amazon.it?	Quale è la procedura di uso per lo sportello di ricarica?	False
In che modo è possible trasferire ebook non procurati su LaFeltrinelli Internet Bookshop SRL?	A che ora devo arrivare al mio punto di raccolta/incontro?	False
Se un acquirente utilizza un coupon, l’ammontare del pagamento cambierà?	Se viene utilizzato un coupon, il pagamento nei miei confronti cambierà?	True
Per quale ragione Ryanair invia i voucher di viaggio?	Vorrei creare un collegamento tra Twitter ed il mio sito per mostrare gli aggiornamenti, come posso fare?	False
Cosa posso fare se perdo le chiavi?	Come faccio a recuperare le chiavi in caso le perdessi?	True
In cosa consiste Workplace Advanced?	Vorrei essere sicuro che una volta preparata la mia inserzione questa venga pubblicata subito, come posso fare?	False
Che tipo di foto devo caricare?	Ci sono sconti per bambini o studenti?	False
Su cosa si basa l’opzione di risparmio energetico?	Perché gli account vengono sospesi?	False
Cosa posso acquistare con le Gift Card Despar?	È possibile cambiare la password?	False
Che cosa succede se l'acquirente chiede un rimborso e ha pagato con un coupon?	I miei dati sono al sicuro?	False
Come faccio a eliminare il mio account?	Perché non riesco ad accedere all'app Tesla dopo la consegna?	False
Che cos'è una cancellazione 'non rimborsabile' o 'cancellazione gratuita'?	Cosa significa cancellazione 'non rimborsabile' e 'cancellazione gratuita'?	True
Come posso ottenere una fattura per il mio soggiorno?	Come può essere speso un voucher di viaggio?	False
Posso usare il mio tolino anche senza effettuare la registrazione?	Dove prendo più informazioni riguardo le funzionalità della mia Tesla?	False
Non riesco a reperire un ricambio per la mia vecchia Yamaha. Cosa posso fare?	Devo sostituire un pezzo della mia moto ma non riesco a recuperarlo, come posso procedere?	True
I miei dati sono al sicuro?	I miei dati sono protetti?	True
Per andare in Gran Bretagna o in Svizzera è obbligatorio il passaporto?	Come si può confermare una prenotazione?	False
Come risponde Workplace alle richieste di informazioni e dati sulla mia organizzazione o sui miei dipendenti da parte del governo o delle forze dell'ordine?	In che modo vengono gestite le mie informazioni in caso di richiesta da parte del governo o delle forze dell’ordine	True
I coupon hanno una data di scadenza?	Come sono variate le tariffe con l'introduzione del sistema MITT?	False
Come può essere speso un voucher di viaggio?	Perché non riesco ad accedere all’app Tesla che mi è stata consegnata?	False
Dove posso usare i nuovi piani?	I voucher di viaggio sono cedibili ad amici o parenti?	False
Ho sbagliato a digitare la mail e/o il numero di cellulare in fase di registrazione al sito	In che modo Workplace protegge le mie informazioni?	False
Che cos’è un coupon?	Quali sono gli aspetti principali sulla guida alle basse temperature?	False
Cos'è un ereader?	C'è un limite al numero di biglietti che posso acquistare per una partita?	False
In che modo è possible trasferire ebook non procurati su LaFeltrinelli Internet Bookshop SRL?	Cos'è la modalità Valet?	False
É possibile aggiungere uno o più testi ad un ordine già confermato?	È possibile aggiungere articoli ad un ordine che è già stato confermato?	True
Devo comunque pagare se annullo una prenotazione?	In caso di annullamento della prenotazione, mi viene addebitato il costo?	True
Posso usare buoni / codici sconto?	È possibile utilizzare dei codici o buoni sconto?	True
Quali vantaggi fornisce un account My Ryanair?	Come posso avere chiavi di riserva o duplicati per la mia Yamaha?	False
Ho sbagliato a digitare la mail e/o il numero di cellulare in fase di registrazione al sito	Il costo di workplace verrà maggiorato iscrivendosi a Workplace premium?	False
Il mio tolino pulò funzionare senza registrazione?	Esiste un tempo limite oltre il quale i Tweet vengono cancellati automaticamente?	False
Devo comunque pagare se annullo una prenotazione?	Come invio un reclamo in materia di copyright, impersonificazione, marchi o altri problemi con i Termini di Servizio?	False
Come faccio a sapere cosa è incluso o escluso nel mio acquisto?	Cosa è incluso nell'acquisto?	True
Quali articoli non posso vendere su Amazon.it?	Si possono vendere medicinali su Amazon?	True
Quando inizierò a pagare la mia quota di abbonamento mensile?	Quando devo pagare la quota di abbonamento?	True
Cosa succede quando un dipendente non lavora più nell'azienda?	Posso iscrivermi solo alla funzione per il lavoro frontline?	False
Parto con un volo nazionale. Quante valigie posso portare? Di che peso?	Quante valigie posso imbarcare se parto con un volo nazionale? qual'è il peso massimo consentito per i bagagli?	True
I clienti possono lasciare recensioni e che impatto ha questo feedback?	È necessario creare un Adobe ID?	False
Cosa faccio se ho bisogno di assistenza medica in caso di emergenza mentre sono in viaggio?	Cosa devo fare durante il volo se ho bisogno di assistenza medica?	True
Qual'è il volume massimo di liquidi che posso mettere nel bagaglio a mano? Quali liquidi posso portare?	Vorrei essere sicuro che una volta preparata la mia inserzione questa venga pubblicata subito, come posso fare?	False
Come si possono cambiare le date del mio prossimo viaggio?	È possibile cambiare le date della prenotazione?	True
Come posso registrarmi?	Come ci si può registrare?	True
Non riesco ad effettuare l’accesso al sito	Dove vengono inviati i biglietti?	False
Cos'è il programma visa waiver? Cosa devo sapere di questo programma se parto per l'america?	Posso ottenere un documento di conferma del ritardo di più di 3 ore valido per fini assicurativi?	False
Come faccio a prenotare i testi scolastici indicati dalla mia scuola?	Che documenti devo presentare per vedere la partita?	False
Che cosa succede se pago utilizzando un coupon e poi il pagamento viene stornato?	Cosa succede al mio coupon se il pagamento viane stornato?	True
A che ora devo arrivare alla partita?	Perché ricevo un voucher di viaggio da Ryanair?	False
Cosa posso acquistare con il mio voucher di viaggio?	Come può essere speso un voucher di viaggio?	True
Come trovo delle persone da seguire?	Non riesco ad iniziare a seguire le persone, mi aiutate?	True
Per usufruire di Workplace serve un account Facebook?	I biglietti prevedono posti contigui?	False
In cosa consiste Workplace Essential?	Cosa posso fare se perdo le chiavi?	False
Come posso utilizzare il mio Credito di Volo?	Come posso utilizzare il mio Credito di Volo sul mio prossimo viaggio?	True
Potreste inviarmi di nuovo la email di conferma della registrazione?	Come si passa attraverso le schermate del pannello strumenti di Model S e Model X?	False
Cosa posso fare se non trovo il campo per inserire il codice coupon presso un vendidtore?	Si può modificare una prenotazione?	False
Posso usare il mio tolino anche senza effettuare la registrazione?	Per andare in Gran Bretagna o in Svizzera è obbligatorio il passaporto?	False
Quali sono i vantaggi per il venditore?	Che vantaggi ha il venditore accettando coupon?	True
Per quanto tempo sono coperto dalla polizza assicurativa?	Quali sono i termini temporali della copertura assicurativa?	True
Posso leggere sul mio tolino anche i vecchi acquisti?	I miei vecchi acquisti sono disponibili sul mio tolino?	True
Come faccio a sapere se i libri da me prenotati sono pronti per essere ritirati presso il punto vendita?	In cosa consiste la modalià frontline di Workplace?	False
Qual è la differenza tra i piani gratuiti e a pagamento?	In che cosa differiscono piani gratuiti e a pagamento?	True
Cosa succede in caso di cancellazione da parte dell'ospite?	Come posso dare accesso all’app ai miei famigliari?	False
Cosa succede in caso di cancellazione da parte dell'ospite?	Come si prosegue con la disdetta?	True
È possibile fare fotografie o video dovunque?	Ci sono sconti per bambini, giovani, anziani o studenti?	False
Per quale ragione Ryanair invia i voucher di viaggio?	Come cambiano le regole in attrezzature di lavoro?	False
Posso scattare foto in un museo?	Posso fare foto o video all'interno di qualsiasi museo o attrazione?	True
In cosa consiste la modalià frontline di Workplace?	Il saldo rimanente di un voucher di viaggio può essere riutilizzato in un'altra prenotazione?	False
Come posso trasferire sul mio tolino gli ebook non acquistati su LaFeltrinelli Internet Bookshop SRL?	In che modo è possible trasferire ebook non procurati su LaFeltrinelli Internet Bookshop SRL?	True
Che tipo di assistenza offre Workplace?	In che modo Workplace assiste I clienti?	True
Posso portare a bordo il personal computer?	I miei dati sono protetti?	False
Come mi iscrivo per vendere i miei prodotti su Amazon?	Che cosa si intende con “acquisto singolo” tra i requisiti per l’utilizzo di un coupon?	False
Non riesco a trovare un libro che vorrei prenotare	Cosa posso fare se un libro non è presente nel catalogo?	True
Cos'è un coupon?	Che cos'è il cloud tolino?	False
Posso offrire confezioni regalo e biglietti di auguri ai miei clienti su Amazon.it?	Come posso inviarvi i miei consigli e suggerimenti?	False
Come si attivano e usano i comandi vocali?	Dopo l'aggiornamento è più facile o più difficile inserire delle review e delle promozioni?	False
Che cosa si intende con “acquisto singolo” tra i requisiti per l’utilizzo di un coupon?	Cosa comporta il requisito 'acquisto singolo' sui coupon?	True
Dove trovo informazioni riguardanti la camera e i servizi della struttura?	Un neonato ha diritto al voucher di viaggio nel caso di annullamento della prenotazione?	False
Quali sono gli oggetti non consentiti nel bagaglio a mano?	Potete inviare un documento di conferma della cancellazione del volo per l'assicurazione?	False
Cosa comporta avere un posto con 'vista limitata'?	Cosa significa che un posto ha 'vista limitata'?	True
Come effettuo la registrazione su un ereader tolino?	Ho prenotato il mio volo tramite un agente di viaggio. Come faccio a ricevere il mio voucher di viaggio?	False
Non riesco a trovare un libro che vorrei prenotare	In che cosa consiste un ereader?	False
Serve il passaporto per andare in paesi non appartenenti all'UE?	Durante il volo posso consumare cibo portato da casa?	False
Quanto vale il mio voucher di viaggio?	Cos'è Twitter?	False
Come posso monitorare l'utilizzo energetico?	Come visualizzo il controllo energetico ?	True
Quali sono le procedure di accensione e spegnimento della mia auto?	Ci sono delle operazioni che devo effettuare prima di lasciare la mia moto ferma per molto tempo?	False
Come faccio a sapere se i libri da me prenotati sono pronti per essere ritirati presso il punto vendita?	Mi arriva una notifica quando i libri sono pronti per essere ritirati nel punto vendita?	True
Come faccio a sapere cosa è incluso o escluso nel mio acquisto?	Dove verifico cosa è incluso nell'acquisto?	True
Posso utilizzare un coupon insieme a un buono regalo per comprare un oggetto su eBay?	Ho eliminato l'email ricevuta contenente il voucher di viaggio, come faccio a scoprire quale è il mio codice voucher univoco?	False
I miei dati sono protetti?	I dati che ho inserito sono protetti?	True
In che modo posso procedere per la rimozione del mio profilo?	La prenotazione può essere cancellata?	False
Qual è la relazione tra il prezzo del biglietto e l'area in cui ci si siede?	Che relazione c'è tra prezzo del biglietto e zona in cui si soggiorna?	True
Posso usare un laptop sull'aereo?	Dove trovo le informazioni dettagliate sul mio tour?	False
Sono cardiopatico e indosso lo stimolatore cardiaco. Posso passare attraverso il metal detector?	Il metal detector è in grado di rilevare lo stimolatore cardiaco che porto?	True
Come riceverò i miei biglietti?	Dove vengono inviati i biglietti?	True
Come si inseriscono i prodotti da vendere su Amazon?	Come metto i prodotti in vendita su Amazon?	True
Come posso disattivare le persone non attive dal mio account Workplace Advanced o Enterprise?	Le persone che non hanno un account attivo come possono essere di disattivate?	True
Posso portare a bordo il personal computer?	È consentito usare il laptop a bordo?	True
Mi piacerebbe provare Workplace.	Cos'è la modalità Valet?	False
Posso convertire il mio voucher di viaggio in contanti?	È possibile convertire in contanti un voucher di viaggio?	True
La mia organizzazione è soggetta ai requisiti di elaborazione dei dati dell'Unione europea. Posso usare Workplace?	Per portare a bordo i medicinali mi serve un certificato medico?	False
È necessario iscriversi per ottenere un account?	Devo iscrivermi per ricevere un account?	True
Posso filmare lo spettacolo?	Come invio un reclamo in materia di copyright, impersonificazione, marchi o altri problemi con i Termini di Servizio?	False
Quali sono le funzioni disponibili su Workplace che possono sostituire alcuni degli strumenti di lavoro esistenti della mia azienda?	I biglietti sono prenotati con il mio nome. Posso cambiare il nome del viaggiatore principale?	False
Che servizio di preciso mi offre il sito?	Serve un  abbigliamento particolare per prendere parte ad un tour?	False
Perché non riesco ad accedere all'app Tesla dopo la consegna?	Perché non riesco ad accedere all’app Tesla che mi è stata consegnata?	True
Il mio utente o la mia password sono errati, posso recuperarli?	I tour e le attrazioni prevedono un numero massimo di biglietti acquistabili?	False
È necessario creare un account Facebook personale per usare Workplace?	Cosa comporta l'impostazione di risparmio energetico?	False
Dove posso utilizzare le card?	Esiste una lista di negozi dove posso utilizzare la mia carta?	True
Quali sono gli orari di check-in della struttura alberghiera da me prenotata?	Dove posso consultare gli orari di check-in e check-out dell'albergo prenotato?	True
Chi esegue l'addebito sulla mia carta?	Dove dovrei posizionare un eventuale transponder / telepass?	False
I dati presenti su workplace saranno disponibili anche dopo un cambio piano?	Cos'è la nuova 'Carta a Scalare'?	False
È necessario creare un account Facebook personale per usare Workplace?	Per usufruire di Workplace serve un account Facebook?	True
Cosa non posso portare nel bagaglio a mano?	Devo evitare di mettere alcuni oggetti nel bagaglio a mano?	True
Come mi registro come venditore su Amazon.it?	Quando sarà autorizzato l'accesso?	False
Come posso essere certo che il mio annuncio venga pubblicato?	Vorrei essere sicuro che una volta preparata la mia inserzione questa venga pubblicata subito, come posso fare?	True
Il mio profilo ora è diverso, quali cambiamenti ha subito?	Gli interventi di manutenzione ordinaria sono coperti dalla garanzia?	False
Come si effettua un ordine	Come posso fare un ordine sul vostro sito?	True
Come posso registrarmi su un ereader tolino?	Dove si comprano gli accessori della Tesla?	False
Perché la mia azienda dovrebbe pagare per Workplace Advanced e Workplace Enterprise se alcune delle funzioni sono disponibili su Facebook e Workplace Essential?	In che tempistichesatanno disponibili I nuovi piani	False
Quanto mi costa vendere su Amazon.it?	Quanto costa vendere su Amazon?	True
Cosa ottengo in cambio della commissione che pago?	Come posso comportarmi nel caso in cui non avessi un accuout LaFeltrinelli Internet Bookshop SRL?	False
Cos'è coperto dall'assistenza stradale?	Cosa copre l’assistenza stradale?	True
Una volta terminato il periodo di lavoro di un dipendente, cosa succederà?	Posso pagare il mio soggiorno usando una carta diversa da quella utilizzata per la prenotazione?	False
Ho l'hobby della caccia. A quali disposizioni devo attenermi per portare a bordo armi e munizioni?	Con quali regole o limiti posso imbarcare il mio fucile e l'attrezzatura da caccia?	True
Quali sono gli oggetti non consentiti nel bagaglio a mano?	Cosa non posso portare nel bagaglio a mano?	True
Solo gli utenti eBay possono utilizzare coupon?	I dati del mio account sono condivisi con terze parti?	False
Che servizi sono inclusi nel costo?	"A cosa serve il pulsante ""follow""?"	False
Sono previsti sconti per bambini o studenti?	Come passo da una schermata all'altra sul pannello strumenti di Model S e Model X?	False
Perché non posso vedere tutti i miei Tweet? Sono stati persi?	Chi devo contattare per notificare il mio cambio di domicilio?	False
In che tempistichesatanno disponibili I nuovi piani	Posso cancellare la mia prenotazione?	False
Cos'è la 'Range Mode'?	A che serve la Range Mode?	True
Si possono vendere medicinali su Amazon?	Cos'è la 'Range Mode'?	False
Posso cambiare le date della mia prenotazione se è 'non rimborsabile'?	"È possibile cancellare o modificare le date di una prenotazione ""non rimborsabile""?"	True
Chi stabilisce il prezzo di vendita per la mia prenotazione?	Quali posti sono considerati i migliori?	False
A cosa serve Vendita su Amazon?	Posso ottenere un documento di conferma del ritardo di più di 3 ore valido per fini assicurativi?	False
Come faccio a segnalare lo spam?	Ho ricevuto numerose richieste da sconosciuti, come faccio a rimuoverle?	True
Come scopro di più sulla Model 3?	Mi saprebbe dare più informazione sul Model 3?	True
Come posso selezionare una copertina per il mio libro senza personalizzazioni?	Come posso confermare la mia prenotazione?	False
Quali sono gli orari di check-in e di check-out della mia prenotazione alberghiera?	Quali sono gli orari di check-in della struttura alberghiera da me prenotata?	True
Come posso abbinare il mio telefono tramite Bluetooth?	Come si aggiunge il telefono all’app via bluetooth?	True
Che servizi sono inclusi nel costo?	Come funziona lo sportello di ricarica?	False
Dove posso trovare i miei biglietti?	Dove vengono inviati i biglietti?	True
Quali documenti devo portare per viaggiare verso gli USA?	Ho ricevuto un voucher di viaggio da Ryanair, ho ancora diritto alla compensazione EU261?	False
Avete una certificazione SOC?	Siete in possesso di una certificazione SOC?	True
Quali saranno le conseguenze di questo cambiamento per i clienti di Workplace nelle Filippine, in Indonesia, in Nuova Zelanda, a Singapore e a Hong Kong?	Chi posso contattare riguardo la mia prenotazione Rooms Direct?	False
É possibile annullare uno o più testi prenotati?	C'è la possibilità di annullare un ordine di libri già pagati?	True
Qual è la differenza tra Platea, Galleria, Balconata ecc.?	In cosa differiscono Platea, Galleria, Balconata, ecc.?	True
Dopo che ho compilato il modulo cosa faccio?	Quali sono i passi successivi alla compilazione del modulo su Subito?	True
Ho l'hobby della caccia. A quali disposizioni devo attenermi per portare a bordo armi e munizioni?	Esiste un tempo limite oltre il quale i Tweet vengono cancellati automaticamente?	False
Come autorizzo l'accesso all'app alla mia famiglia?	Come posso dare accesso all’app ai miei famigliari?	True
Vorrei provare Workplace.	Mi piacerebbe provare Workplace.	True
Per andare in Gran Bretagna o in Svizzera è obbligatorio il passaporto?	Serve il passaporto per andare nel regno unito o in svizzera?	True
In che tempistichesatanno disponibili I nuovi piani	Potete inviare un documento di conferma della cancellazione del volo per l'assicurazione?	False
In che posizione si trova il mio annuncio?	Come faccio a sapere la visibilità del mio annuncio nella ricerca?	True
Quali documenti sono necessari per viaggiare con un minore?	Quali documenti servono se ho un figlio minore di 18 anni?	True
Che tipo di foto devo caricare?	Come posso fare il check-in fuori dall'orario prestabilito?	False
Come pubblico una foto su Twitter?	Ho delle immagini e vorrei pubblicarle su Twitter, come posso fare?	True
C'è un neonato incluso nella mia prenotazione annullata. Ha diritto a un voucher di viaggio?	Posso continuare a inserire in categoria attrezzature di lavoro?	False
Cos'è la nuova 'Carta a Scalare'?	Cos'è e come funziona la nuova Carta a Scalare?	True
Qual'è il volume massimo di liquidi che posso mettere nel bagaglio a mano? Quali liquidi posso portare?	Perché gli account vengono sospesi?	False
Posso filmare lo spettacolo?	Quali sono i tempi previsti per la ricezione di un voucher di viaggio dopo l'annullamento del volo?	False
Come utilizzo il codice indicato sul coupon?	Come si utilizza il coupon?	True
Ho dimenticato la password	Di quali informazioni ho bisogno per l'iscrizione?	False
Cosa significa per utente al mese?	Cosa si intende per utente al mese?	True
Come viene erogata assistenza medica in viaggio?	Vorrei sapere come posso fare per evitare che i maleintenzionati si approprino dei miei dai sensibili.	False
Quanto vale il mio voucher di viaggio?	Che valore ha il mio voucher di viaggio?	True
Come posso aggiungere le copertine ai libri?	È possibile aggiungere delle copertine ai libri che ho ordinato?	True
Quindi ora è più facile scrivere una recensione, giusto? E le promozioni a cui ho partecipato?	Dopo l'aggiornamento è più facile o più difficile inserire delle review e delle promozioni?	True
La partecipazione alle partite è indicata per i bambini?	Nel caso dovessi avvalermi della garanzia sul veicolo, in quale concessionaria dovrei recarmi?	False
Cosa posso vendere su Amazon?	Cosa posso vendere su Amazon.it?	True
Avete una sicurezza di livello enterprise?	é garantita una sicurezza di livello enterprise?	True
É possibile annullare uno o più testi prenotati?	Che servizi sono inclusi nel costo?	False
Si possono vendere medicinali su Amazon?	Cosa succede quando un dipendente non lavora più nell'azienda?	False
Che cos’è un coupon?	Come posso sapere chi mi sta seguendo?	False
È possibile modificare una prenotazione?	Perché non posso vedere tutti i miei Tweet? Sono stati persi?	False
Qual è la differenza tra una risposta e un Messaggio Diretto?	Che differenza c'è tra un messaggio privato ed un commento ad un Tweet?	True
Ci sono sconti per bambini, giovani, anziani o studenti?	Sono previsti sconti particolari per studenti o determinate fascie d'età?	True
Perchè un nuovo sito?	Perchè non utilizzare un sito già esistente?	True
Cosa faccio se ho bisogno di assistenza medica in caso di emergenza mentre sono in viaggio?	Come viene erogata assistenza medica in viaggio?	True
Che cosa è cambiato?	Quali sono le differenze con il sito precedente?	True
È possibile fare fotografie o video dovunque?	Cosa posso acquistare con il mio voucher di viaggio?	False
Dovrò effettuare l'accesso ogni volta che prenoto un volo?	Devo effettuare un accesso ogni volta che prenoto?	True
C'è un limite al numero di biglietti che posso acquistare per un tour o un’ attrazione?	I tour e le attrazioni prevedono un numero massimo di biglietti acquistabili?	True
Quali saranno le conseguenze di questo cambiamento per i clienti di Workplace nelle Filippine, in Indonesia, in Nuova Zelanda, a Singapore e a Hong Kong?	Cosa è incluso nell'acquisto?	False
Devo iscrivermi per ricevere un account?	Devo iscrivermi per ottenere un account?	True
Non ricordo più la mia password dell'account.	Quando sarà autorizzato l'accesso?	False
Quando inizierò a pagare la mia quota di abbonamento mensile?	Come posso avere chiavi di riserva o duplicati per la mia Yamaha?	False
Posso usare il mio tolino anche senza effettuare la registrazione?	Il mio tolino pulò funzionare senza registrazione?	True
Cos'è un Retweet?	Come funziona la ripubblicazione di un Tweet?	True
Come posso registrarmi su un ereader tolino?	Come ci si registra?	False
Come autorizzo l'accesso all'app alla mia famiglia?	Perché non posso vedere tutti i miei Tweet? Sono stati persi?	False
Sono cardiopatico e indosso lo stimolatore cardiaco. Posso passare attraverso il metal detector?	Posso cambiare il nome del viaggiatore principale una volta che ho prenotato a nome mio?	False
Qual è la differenza tra i piani gratuiti e a pagamento?	Cosa significa che un posto ha 'visibilità ridotta'?	False
Nel caso in cui io abbia acquistato Workplace da un rivenditore partner, quali potrebbero essere le conseguenze?	Come si attivano e usano i comandi vocali?	False
In che modo Workplace protegge le mie informazioni?	Si può guidare l’auto mentre è in corso un aggiornamento software?	False
Come mi registro per vendere prodotti su Amazon.it?	Come posso monitorare l'utilizzo energetico?	False
È possibile pagare il soggiorno con una carta diversa da quella indicata nella prenotazione?	Ho prenotato il mio volo tramite un agente di viaggio. Come faccio a ricevere il mio voucher di viaggio?	False
Chi posso contattare in caso di problemi?	Posso portare a bordo il personal computer?	False
Quanto costa vendere su Amazon?		True
Come faccio ad aggiungere un dipendente frontline a Workplace?	In che modo è possibile aggiungere un dipendente frontline a Workplace?	True
Che cos'è un posto con 'visibilità ridotta'?	Perchè devo verificare il mio numero di telefono?	False
Dove posso acquistare gli accessori per la mia Tesla?	Dove si comprano gli accessori della Tesla?	True
Ho prenotato un tour per una fascia oraria, a che ora devo presentarmi?	Se prenoto una fascia oraria, quando devo arrivare?	True
Perché la mia azienda dovrebbe pagare per Workplace Advanced e Workplace Enterprise se alcune delle funzioni sono disponibili su Facebook e Workplace Essential?	Per quale motivo la mia azienda pagherebbe per avere un servizio da Workplace Advanced e Workplace Enterprise se comunque molte funzionalità sono già presenti su Facebook e Workplace Essential?	True
Cosa posso fare con il mio Credito di Volo?	Gli interventi di manutenzione ordinaria sono coperti dalla garanzia?	False
È necessario creare un Adobe ID?	È possibile utilizzare dei codici o buoni sconto?	False
Devo iscrivermi per ricevere un account?	Esiste un tempo limite oltre il quale i Tweet vengono cancellati automaticamente?	False
Gli ospiti come possono pagare le prenotazioni?	Come posso utilizzare il mio Credito di Volo sul mio prossimo viaggio?	False
Posso inserire gli aggiornamenti che pubblico su Twitter sul mio blog?	Vorrei creare un collegamento tra Twitter ed il mio sito per mostrare gli aggiornamenti, come posso fare?	True
Quante valigie posso imbarcare se parto con un volo nazionale? qual'è il peso massimo consentito per i bagagli?	I biglietti prevedono posti contigui?	False
Come posso fare il check-in fuori dall'orario prestabilito?	In caso di ritardo, cosa devo fare per effettuare il check-in fuori dall'orario prestabilito?	True
I coupon hanno una scadenza?	Condividete i dati degli utenti con terze parti?	False
Come funziona la frenata d'emergenza automatica?	In cosa consiste la frenata d'emergenza automatica?	True
Come faccio a eliminare il mio account?	In che modo posso procedere per la rimozione del mio profilo?	True
Cosa posso fare se non trovo il campo per inserire il codice coupon presso un vendidtore?	È consentito usare il laptop a bordo?	False
Cosa posso vendere su Amazon.it?	Posso effettuare una prenotazione se non voglio iscrivermi?	False
La mia carta è stata addebitata e non ho ancora soggiornato.	Come mai ho ricevuto un addebito ma non ho ancora soggiornato?	True
Che vantaggi ha il venditore accettando coupon?	Di quali dati mi devo munire prima di fare la registrazione?	False
Dove posso trovare tutte le informazioni sul mio tour ed attrazione (ad es. Ora di inizio, durata, ecc.)?	Quali sono le caratteristiche dell’Autopilot e come si usa?	False
Cosa succdede se ho un annuncio online in una categoria attrezzature di lavoro?	Devo preoccuparmi se ho delle inserzioni attive in attrezzature da lavoro?	True
Come effettuo la registrazione su un ereader tolino?	I dati che ho inserito sono protetti?	False
Posso cancellare la mia prenotazione?	La prenotazione può essere cancellata?	True
Chi decide il prezzo della mia prenotazione?	Come è calcolato il prezzo di una prenotazione?	True
Chi addebiterà la mia carta?	Chi esegue l'addebito sulla mia carta?	True
Posso registrare o fare foto allo spettacolo?	Posso filmare lo spettacolo?	True
Qual è il costo per la funzione di lavoro frontline?	In che maniera vengono inviati i voucher regalo?	False
Quali sono i regolamenti e il codice di condotta della sede?	Come posso dare accesso all’app ai miei famigliari?	False
Posso iscrivermi solo alla funzione per il lavoro frontline?	è possibile iscriversi unicamente per la funzione di lavoro frontline?	True
A che ora devo arrivare per lo spettacolo?	A che ora devo recarmi nel luogo dello spettacolo?	True
Quali sono i prodotti che vanno in categoria attrezzature di lavori?	Come funziona la ripubblicazione di un Tweet?	False
Devo avere un conto PayPal per utilizzare il coupon?	Dove vengono salvati i miei acquisti?	False
I biglietti sono validi solo per la fascia oraria prefissata?	I biglietti valgono soltanto durante la fascia oraria selezionata?	True
	In che modo Workplace assiste I clienti?	False
A che ora devo arrivare alla partita?	A che ora devo presentarmi alla partita?	True
Come si prosegue con la disdetta?	Che cos’è un posto con 'vista limitata'?	False
Ho diritto al rimboso o posso riprenotare un volo annullato dopo aver rivevuto il voucher di viaggio?	Come posso inviarvi i miei consigli e suggerimenti?	False
Chi posso contattare in caso di problemi?	Cosa succede dopo aver salvato una ricerca?	False
C'è un neonato incluso nella mia prenotazione annullata. Ha diritto a un voucher di viaggio?	Un neonato ha diritto al voucher di viaggio nel caso di annullamento della prenotazione?	True
Ho ricevuto un addebito nonostante non abbia ancora soggiornato.	Dove prendo più informazioni riguardo le funzionalità della mia Tesla?	False
Come posso fare un ordine sul vostro sito?	osso utilizzare un coupon per volta?	False
Ci sono sconti per bambini, giovani, anziani o studenti?	Cosa succede se modifico un annuncio dal mio profilo Subito?	False
I coupon hanno una scadenza?	I coupon scadono?	True
Quali informazioni dovrei portare con me per entrare a vedere la partita?	Che documenti devo presentare per vedere la partita?	True
Mi arriva una notifica quando i libri sono pronti per essere ritirati nel punto vendita?	Perché gli account vengono sospesi?	False
É possibile aggiungere uno o più testi ad un ordine già confermato?	Di quali dati mi devo munire prima di fare la registrazione?	False
Ho subìto un ritardo e devo effettuare il check-in al di fuori dell’orario prestabilito, cosa devo fare?	In caso di ritardo, cosa devo fare per effettuare il check-in fuori dall'orario prestabilito?	True
Come mai ho ricevuto un addebito ma non ho ancora soggiornato?	Ho ricevuto un addebito nonostante non abbia ancora soggiornato.	True
Serve un  abbigliamento particolare per prendere parte ad un tour?	Le attrazioni e i tour prevedono un dressing code?	True
Come mai c'è una differenza di prezzo tra Platea e Galleria?	Che relazione c'è tra prezzo del biglietto e zona in cui si soggiorna?	True
Come posso utilizzare il mio Credito di Volo sul mio prossimo viaggio?	Cosa posso fare con il mio Credito di Volo?	True
Quali sono i costi?	A quanto ammontano I costi?	True
È necessario iscriversi per ottenere un account?	Devo iscrivermi per ottenere un account?	True
Come effettuo la registrazione su un ereader tolino?	Come posso registrarmi su un ereader tolino?	True
In cosa consiste la modalià frontline di Workplace?	C’è pubblicità su Workplace?	False
Cosa succdede se ho un annuncio online in una categoria attrezzature di lavoro?	Quindi ora è più facile scrivere una recensione, giusto? E le promozioni a cui ho partecipato?	False
La mia scuola mi ha dato una lista di libri da comprare, come posso prenotarli?	Come posso fare il check-in fuori dall'orario prestabilito?	False
Come posso contattare il servizio clienti Yamaha?	Vorrei sapere a quali numeri telefonici è possibile chiamarvi per risolvere alcuni problemi.	True
Devo confermare ogni prenotazione?	Devo iscrivermi per ottenere un account?	False
Dove vengono salvati i miei acquisti?	Dove posso trovare gli acquisti effettuati?	True
Come posso inviarvi i miei consigli e suggerimenti?	Vorrei contribuire a migliorare il sito, come faccio?	True
Come viene erogata assistenza medica in viaggio?	Come sono variate le tariffe con l'introduzione del sistema MITT?	False
Come posso attivare la funzione Summon?	Come si attiva l’opzione Summon?	True
	In che modo è possibile prevedere il costo di Workplace in base al prezzo per utente al mese?	False
Perché gli account vengono sospesi?	Il mio account è stato bloccato e non riesco più ad accedervi, come faccio?	True
Che cosa faccio se l’indirizzo email associato al mio coupon è diverso da quello che uso per il conto PayPal?	Cosa devo fare se PayPal e il mio account hanno diverso indirizzo email?	True
Di quali informazioni ho bisogno per l'iscrizione?	Quali dati devo inserire per l'iscrizione?	True
Come mi devo comportare se trovo una validatrice, a bordo mezzo o in stazione, guasta che non mi permette di effettuare la validazione?	Cosa devo fare se l'obliteratrice non funziona?	True
Sono diretto in un Paese della Comunità Europea. Che documento devo portare?	Quale documento mi serve per viaggiare nei paesi della comunità europea?	True
Cosa comporta il requisito 'acquisto singolo' sui coupon?	Mi serve qualcosa di particolare per utilizzarlo?	False
Dove posso trovare tutte le informazioni sulla mia partita (ad es. ora di inizio, durata ecc.)?	Dove è possibile reperire le informazioni sulla partita?	True
Posso iscrivermi solo alla funzione per il lavoro frontline?	Su cosa si basa l’opzione di risparmio energetico?	False
È possibile annullare un ordine anche se mi è già stato confermato via SMS?	Dove posso consultare gli orari di check-in e check-out dell'albergo prenotato?	False
Dopo posso far riparare la mia auto?	Dove posso portare a riparare l’auto?	True
Qual è la relazione tra il prezzo del biglietto e l'area in cui ci si siede?	Come mai c'è una differenza di prezzo tra Platea e Galleria?	True
Sono un cliente attuale di Workplace Standard. Quali sono le conseguenze per me?	Come posso ricevere una fattura?	False
Come faccio ad aggiungere un altro contatto al mio account?	Come si inseriscono nuovi contatti all’account utente?	True
Chi posso contattare in caso di problemi?	Come posso disattivare le persone non attive dal mio account Workplace Advanced o Enterprise?	False
Ho subìto un ritardo e devo effettuare il check-in al di fuori dell’orario prestabilito, cosa devo fare?	Come posso fare il check-in fuori dall'orario prestabilito?	True
Quali metodi di pagamento ho a disposizione per utilizzare un coupon?	Come posso pagare per utilizzare un coupon?	True
È richiesto un abbigliamento particolare per qualsiasi attrazione o tour?	Serve un  abbigliamento particolare per prendere parte ad un tour?	True
Come si prosegue con la disdetta?	Chi esegue l'addebito sulla mia carta?	False
Il venditore accetta PayPal come metodo di pagamento.	Chi decide il prezzo della mia prenotazione?	False
Come posso prenotare se non voglio iscrivermi?	Posso prenotare un volo senza iscrizione?	True
Quante aziende usano Workplace?	Cosa posso fare se non ho un account LaFeltrinelli Internet Bookshop SRL?	False
Il metal detector è in grado di rilevare lo stimolatore cardiaco che porto?	Posso utilizzare più di un voucher di viaggio in una determinata prenotazione?	False
Chi posso contattare riguardo la mia prenotazione Rooms Direct?	A chi devo rivolgermi per gestire la prenotazione Rooms Direct?	True
Quando sarà autorizzato l'accesso?	Quando avrò accesso all’app?	True
Quali sono i costi?	Ho effettuato l'iscrizione a Workplace Premium. Il costo totale di Workplace aumenterà?	False
Mi piacerebbe provare Workplace.	Dove dovrei posizionare un eventuale transponder / telepass?	False
In caso di ritardo, cosa devo fare per effettuare il check-in fuori dall'orario prestabilito?	Ho delle immagini e vorrei pubblicarle su Twitter, come posso fare?	False
Quali informazioni dovrei portare con me per entrare nell'attrazione?	Di quali documenti ho bisogno per accedere ad un'attrazione?	True
Ho prenotato il mio volo tramite un agente di viaggio. Come faccio a ricevere il mio voucher di viaggio?	Come ottengo il voucher di viaggio se la prenotazione è stata effettuata da un agenzia?	True
Mi arriva una notifica quando i libri sono pronti per essere ritirati nel punto vendita?	Come posso monitorare l'utilizzo energetico?	False
Quali sono gli orari di check-in e di check-out della mia prenotazione alberghiera?	Come si conferma una prenotazione?	False
I miei biglietti sono validi solo per la fascia oraria prescelta?	I biglietti valgono soltanto durante la fascia oraria selezionata?	True
C'è la possibilità di annullare un ordine di libri già pagati?	Posso acquistare e scaricare i miei ebook direttamente sul lettore mentre mi trovo all'estero?	False
Non riesco ad effettuare l’accesso al sito	Il mio utente o la mia password sono errati, posso recuperarli?	True
É possibile non ritirare un testo anche se ho già ricevuto l’sms/e-mail?	Come posso disattivare le persone non attive dal mio account Workplace Advanced o Enterprise?	False
Perchè devo registrare il mio tolino?	I miei dati sono protetti?	False
Posso leggere sul tolino i miei acquisti, effettuati altrove, di ebook protetti da Adobe DRM?	Posso registrare o fare foto allo spettacolo?	False
Tutte le sedi hanno accessi per sedie a rotelle o forniscono assistenza speciale?	Le strutture prevedono l'accesso per sedie a rotelle o forniscono assistenza speciale?	True
La mia organizzazione è soggetta ai requisiti di elaborazione dei dati dell'Unione europea. Posso usare Workplace?	è possibile usare Workplace anche se soggetti a requisiti di elaborazione dei dati dell’Unione eurpoea?	True
Come mai ho ricevuto un addebito ma non ho ancora soggiornato?	Come posso ricevere una fattura?	False
Cos'è Workplace Advanced?	In cosa consiste Workplace Advanced?	True
Ho effettuato l'iscrizione a Workplace Premium. Il costo totale di Workplace aumenterà?	Come ci si può registrare?	False
Come si utilizza il coupon?	Che tipo di manutenzione richiede la mia nuova Tesla?	False
Parto per gli Stati Uniti d'America. Che cos'è il programma Visa Waiver Program?	Cos'è il programma visa waiver? Cosa devo sapere di questo programma se parto per l'america?	True
Come faccio a usare l'app Tesla?	Come si lancia l’app Tesla?	True
Una volta acquistati, come posso scaricare gli ebook?	Come posso ottenere gli ebook una volta acquistati?	True
Cos'è la funzione per il lavoro frontline di Workplace?	In cosa consiste la modalià frontline di Workplace?	True
Quali sono le modalità di spedizione dei testi prenotati?	I miei biglietti sono validi solo per la fascia oraria prescelta?	False
Posso utilizzare un coupon in qualunque sito eBay o per oggetti in valute diverse?	Possiamo inviarti dei consigli per fare si che la tua pubblicazione non venga rifiutata, li vuoi?	False
Ho dimenticato la password	Non ricordo più la mia password dell'account.	True
Perchè solo ad alcune pagine è stata modifica la grafica?	C'è un motivo per il quale sono alcune pagine è stata cambiata l'interfaccia?	True
Posso apportare modifiche alla mia prenotazione?	Come autorizzo l'accesso all'app alla mia famiglia?	False
Dove posso trovare tutte le informazioni sul mio tour ed attrazione (ad es. Ora di inizio, durata, ecc.)?	Possiamo inviarti dei consigli per fare si che la tua pubblicazione non venga rifiutata, li vuoi?	False
Mi serve qualcosa di particolare per utilizzarlo?	Di quali dati mi devo munire prima di fare la registrazione?	True
é garantita una sicurezza di livello enterprise?	Dove posso rinnovare la carta d'identità scaduta?	False
Il costo di workplace verrà maggiorato iscrivendosi a Workplace premium?	Dove posso portare a riparare l’auto?	False
Che cos'è il cloud tolino?	In che cosa consiste il cloud tolino?	True
Devo confermare ogni prenotazione?	Come viene inviato il voucher regalo?	False
È richiesto un abbigliamento particolare per qualsiasi attrazione o tour?	Come posso abilitare la modalità scura?	False
Quali sono i passi successivi alla compilazione del modulo su Subito?	Nel caso dovessi avvalermi della garanzia sul veicolo, in quale concessionaria dovrei recarmi?	False
Come posso fare un ordine sul vostro sito?	Quando inizia e quando finisce la mia copertura assicurativa?	False
Posso utilizzare un coupon in qualunque sito eBay o per oggetti in valute diverse?	Ci sono sconti per bambini, giovani, anziani o studenti?	False
Che cos'è il cloud tolino?	I miei dati verranno condivisi con qualcun altro?	False
Se si usa attualmente Workplace premium, a quale piano verremo spostati?	Dove posso rinnovare la carta d'identità scaduta?	False
Cosa mi serve per iscrivermi come venditore su Amazon?	Come mi iscrivo per vendere i miei prodotti su Amazon?	True
Che cosa devo fare per accettare un coupon?	Cosa posso fare per accettare coupon?	True
È possibile portare cibo a bordo?	Si può portare cibo sull'aereo?	True
Cosa è possibile comprare con le Gift Card Despar?	C’è un termine per l’utilizzo del coupon?	False
Che cos’è un coupon?	Cos'è un coupon?	True
Vorrei creare un account, da dove iniziare?	A che ora devo recarmi nel luogo dello spettacolo?	False
Quando sarà online la mia struttura?	Quanto peso posso trasportare sulla mia moto se dovessi aggiungere dei bagagli?	False
Dove trovo le informazioni dettagliate sul mio tour?	Cos'è la modalità Valet?	False
Come posso ricevere il voucher?	In che maniera vengono inviati i voucher regalo?	True
Quante aziende usano Workplace?	Qual è il quantitativo di aziende che usa Workplace?	True
I miei dati verranno condivisi con qualcun altro?	Condividete i dati degli utenti con terze parti?	True
Come faccio a navigare nel touchscreen?	Quali sono i comandi di navigazione del touchscreen?	True
Quali articoli non posso vendere su Amazon.it?		True
Dove trovo il mio contratto di compravendita di veicolo a motore (MVPA, Motor Vehicle Purchase Agreement)?	Come posso recuperare il mio contratto di compravendita del mio veicolo a motore?	True
Quali articoli posso vendere su Amazon.it?	Cosa posso vendere su Amazon?	True
Sono presenti inserzioni su Workplace?	Come posso recuperare il mio contratto di compravendita del mio veicolo a motore?	False
Non vedo il mio albergo sul sito. Quando sara' online?	Sono un cliente attuale di Workplace Premium. Quali sono le conseguenze per me?	False
I dati del mio account sono condivisi con terze parti?	Dove posso trovare i miei biglietti?	False
Come posso accendere e spegnere la mia auto?	Quali sono le procedure di accensione e spegnimento della mia auto?	True
Quali documenti sono necessari per viaggiare con un minore?	Come posso trovare l'identificatore del colore della moto che ho acquistato da voi?	False
Nel caso in cui mi trovi all’estero, è possibile acquistare e scaricare gli ebook diretrtamente sul lettore?	Chi esegue l'addebito sulla mia carta?	False
Dove posso trovare tutte le informazioni sul mio tour ed attrazione (ad es. Ora di inizio, durata, ecc.)?	Dove trovo le informazioni dettagliate sul mio tour?	True
Quale documento mi serve per viaggiare nei paesi della comunità europea?	Quali sono gli oggetti non consentiti nel bagaglio da stiva?	False
Posso portare con me a bordo i miei medicinali? Necessito di un certificato medico?	Per portare a bordo i medicinali mi serve un certificato medico?	True
La mia scuola mi ha dato una lista di libri da comprare, come posso prenotarli?	Posso registrare o scattare foto all'interno di qualsiasi attrazione o museo?	False
Quali sono i tempi di evasione dei testi prenotati?	Cosa significa che un posto ha 'vista limitata'?	False
Si possono vendere medicinali su Amazon?		True
Avete sistemi di protezione anti-frode?	Non mi è arrivata la mail di conferma, come faccio?	False
Ho sbagliato a digitare la mail e/o il numero di cellulare in fase di registrazione al sito	È possibile modificare le informazioni personali dopo che mi sono registrato?	True
Se viene utilizzato un coupon, il pagamento nei miei confronti cambierà?	Cosa non posso portare nel bagaglio da stiva?	False
Posso dare il mio voucher di viaggio ad un amico o un parente?	I voucher di viaggio sono cedibili ad amici o parenti?	True
A cosa servono le rotelline sul volante?	Quali funzioni hanno le manopole situate volante?	True
Come posso ottenere gli ebook una volta acquistati?	Come posso utilizzare dei codici sconto?	False
Come ottengo un coupon?	Cosa posso fare se non trovo il campo per inserire il codice coupon presso un vendidtore?	False
È ancora consensito aggiungere inserzioni riguardo le attrezzature da lavoro?	Perché non riesco ad accedere all’app Tesla che mi è stata consegnata?	False
Sono previsti limiti di età nei tour e attrazioni?	Come ottengo il voucher di viaggio se la prenotazione è stata effettuata da un agenzia?	False
Quali sono le modalità di spedizione dei testi prenotati?	Quale metodo di spedizione viene utilizzato?	True
è possibile annullare il piano Workplace Premium?	È possibile utilizzare dei codici o buoni sconto?	False
Posso portare a bordo il personal computer?	È richiesto un abbigliamento particolare per qualsiasi attrazione o tour?	False
Si può portare cibo sull'aereo?	Durante il volo posso consumare cibo portato da casa?	True
I dati presenti su workplace saranno disponibili anche dopo un cambio piano?	Quali sono gli oggetti non consentiti nel bagaglio da stiva?	False
Quali sono i vantaggi di un account My Ryanair?	Quali vantaggi fornisce un account My Ryanair?	True
Come si programma l'opzione Homelink?	Come posso aggiungere l’opzione Homelink?	True
Chi stabilisce il prezzo di vendita per la mia prenotazione?	I biglietti sono per i tifosi della squadra di casa o per gli ospiti?	False
Quali sono le caratteristiche dell’Autopilot e come si usa?	Con l'introduzione del sistema MITT le tariffe sono aumentate?	False
Come funzionano i comandi vocali?	Come si attivano e usano i comandi vocali?	True
Qual è la definizione di dipendente frontline?	Cos’è un dipendente frontline?	True
Posso ricevere informazioni sulla camera da me prenotata?	Dove trovo informazioni riguardanti la camera e i servizi della struttura?	True
Come ottengo un documento di conferma di un ritardo?	Posso ottenere un documento di conferma del ritardo di più di 3 ore valido per fini assicurativi?	True
Quali informazioni dovrei portare con me per entrare nell'attrazione?	I voucher di viaggio possono essere utilizzati all'interno dell'app Ryanair?	False
Posso cancellare il mio abbonamento?	Come faccio a gestire gli ordini?	False
Quanto costa vendere su Amazon?	Come funzionano i comandi vocali?	False
Che cosa devo fare se sto acquistando presso un venditore che accetta PayPal ma non vedo un campo dove inserire il mio codice coupon?	Cosa posso fare se non trovo il campo per inserire il codice coupon presso un vendidtore?	True
Ho effettuato l'iscrizione a Workplace Premium. Il costo totale di Workplace aumenterà?	Condividete i dati degli utenti con terze parti?	False
Serve un  abbigliamento particolare per prendere parte ad un tour?	Cos'è Twitter?	False
Per quale motivo è necessaria la registrazione del mio tolino	Come si inseriscono nuovi contatti all’account utente?	False
Non riesco a trovare un libro che vorrei prenotare	Come posso contattare il servizio clienti Yamaha?	False
Posso cancellare il mio abbonamento?	Qual'è il processo di cancellazione dell'abbonamento?	True
I miei dati sono al sicuro?	Non riesco a reperire un ricambio per la mia vecchia Yamaha. Cosa posso fare?	False
Esiste una lista di negozi dove posso utilizzare la mia carta?	A chi devo rivolgermi per fare una copia della chiave della mia moto?	False
Posso usare buoni / codici sconto?	Come posso utilizzare dei codici sconto?	True
Quanti e quali liquidi è consentito trasportare nel bagaglio a mano?	Qual'è il volume massimo di liquidi che posso mettere nel bagaglio a mano? Quali liquidi posso portare?	True
Cosa succede se una partita per cui ho acquistato i biglietti è stata posticipata o la data/ora è cambiata?	Cosa succede in caso di posticipo o cambio di orario di una partita?	True
Cos'è la modalità Valet?	A cosa serve l’opzione Valet?	True
Come posso inserire i prodotto che devo vendere su Amazon?	Come si inseriscono i prodotti da vendere su Amazon?	True
Cosa posso vendere su Amazon.it?	Ho dimenticato la password	False
Cos’è un dipendente frontline?	Il servizio di garanzia offerto da Yamaha copre anche gli interventi usuali di manutenzione?	False
Cosa è incluso nel prezzo?	Che servizi sono inclusi nel costo?	True
Come riceverò i miei biglietti?	Dove posso trovare i miei biglietti?	True
Posso pagare usando una carta diversa rispetto a quella della prenotazione?	È possibile pagare il soggiorno con una carta diversa da quella indicata nella prenotazione?	True
Cos'è l'Autopilot e come funziona?	Quali sono le caratteristiche dell’Autopilot e come si usa?	True
Come faccio a prenotare i testi scolastici indicati dalla mia scuola?	La mia scuola mi ha dato una lista di libri da comprare, come posso prenotarli?	True
Cosa posso fare per accettare coupon?	Il costo di workplace verrà maggiorato iscrivendosi a Workplace premium?	False
Quanti biglietti per tour posso acquistare?	I voucher di viaggio possono essere utilizzati all'interno dell'app Ryanair?	False
Perché non riesco ad accedere all’app Tesla che mi è stata consegnata?	Vorrei sapere a quali numeri telefonici è possibile chiamarvi per risolvere alcuni problemi.	False
Come faccio a registrarmi al sito?	Vorrei creare un account, da dove iniziare?	True
Come si naviga in questo sito?	Condividete i dati degli utenti con terze parti?	False
Per usufruire di Workplace serve un account Facebook?	Devo iscrivermi per ricevere un account?	False
Chi stabilisce il prezzo di vendita per la mia prenotazione?	Come è calcolato il prezzo di una prenotazione?	True
Posso utilizzare più di un coupon alla volta?	osso utilizzare un coupon per volta?	True
Posso pagare il mio soggiorno usando una carta diversa da quella utilizzata per la prenotazione?	Posso pagare usando una carta diversa rispetto a quella della prenotazione?	True
Gli ospiti hanno rovinato la camera. Cosa si puo' fare?	Come posso preventivare il costo di Workplace conoscendo il presso utente al mese?	False
Posso fare foto o video all'interno di qualsiasi museo o attrazione?	Quali sono le differenze con il sito precedente?	False
Sono diabetico e temo che le mie siringhe non siano autorizzate nel bagaglio a mano. Cosa devo fare?	Dove posso informarmi per sapere cosa fare con le mie iniezioni di insulina?	True
è possibile usare Workplace anche se soggetti a requisiti di elaborazione dei dati dell’Unione eurpoea?	Condividete i dati degli utenti con terze parti?	False
I biglietti hanno posti vicini?	Perché gli account vengono sospesi?	False
Se non confermo una prenotazione?	Dove sono punzonate le matricole del telaio e del motore?	False
Parto con un volo nazionale. Quante valigie posso portare? Di che peso?	I dati che ho inserito sono protetti?	False
Cosa posso fare se non ho un account LaFeltrinelli Internet Bookshop SRL?	Come posso comportarmi nel caso in cui non avessi un accuout LaFeltrinelli Internet Bookshop SRL?	True
Anche il mio profilo cambiato?	Il mio profilo ora è diverso, quali cambiamenti ha subito?	True
Posso usare il computer in volo?	Posso usare un laptop sull'aereo?	True
Clicca qui per avere maggiori informazioni sui prezzi?	Clicca qui per avere ulteriori informazioni riguardo ai prezzi?	True
È possibile portare cibo a bordo?	Durante il volo posso consumare cibo portato da casa?	True
Dove posso trovare ulteriori informazioni sui Termini di Servizio di Twitter?	Come posso recuperare tutte le informazioni sui Termini di partecipazione a Twitter?	True
Cosa devo dare se sono un cliente subito impresa in attrezzature di lavoro?	Nel caso fossi un cliente subito per le imprese, quali dati dovrei fornire?	True
Come faccio a registrarmi al sito?	Dove metto il transponder / telepass?	False
Qual è il periodo di validità (prenotazione e viaggio) del mio voucher di viaggio? Ci sono limiti di data?	Sono previsti dei limiti temporali alla validità di un voucher di viaggio?	True
È possibile utilizzare dei codici o buoni sconto?	Cosa posso fare se resto chiuso fuori dal veicolo?	False
Devo effettuare un accesso ogni volta che prenoto?	È necessario accedere all'account per prenotare un volo?	True
Chi legge i miei aggiornamenti?	È possibile risalire alle persone che leggono i miei Tweet?	True
Le partite sono adatte ai bambini?	La partecipazione alle partite è indicata per i bambini?	True
Devo iscrivermi per ottenere un account?	Si può modificare una prenotazione?	False
Come faccio a sapere se la mia prenotazione è stata cancellata?	A cosa servono le rotelline sul volante?	False
Posso offrire confezioni regalo e biglietti di auguri ai miei clienti su Amazon.it?	Non ricordo più la mia password dell'account.	False
Come riceverò i miei biglietti?	Dove trovo il numero di telaio della mia Tesla?	False
Che cos'è un posto con 'visibilità ridotta'?	Cosa significa che un posto ha 'visibilità ridotta'?	True
Si può portare cibo sull'aereo?	Quali sono gli orari di check-in e di check-out della mia prenotazione alberghiera?	False
Posso spegnere il touchscreen?	Si può disabilitare il touchscreen?	True
Mi verrà addebitato il pagamento se annullo la prenotazione?	In caso di annullamento della prenotazione, mi viene addebitato il costo?	True
Vuoi un suggerimento per evitare che il tuo annuncio venga rifiutato?	Desideri ricevere via email una lista di suggerimenti per migliorare il tuo annuncio?	True
Come utilizzo il coupon?	Perchè un nuovo sito?	False
Tutte le attrazioni hanno accesso per sedie a rotelle o forniscono assistenza speciale?	Le attrazioni prevedono l'accesso e assistenza per disabili o utenti in sedia a rotelle?	True
Che differenza c'è tra cancellazione 'non rimborsabile' e 'cancellazione gratuita'?	Cosa significa cancellazione 'non rimborsabile' e 'cancellazione gratuita'?	True
Quali sono i vantaggi di un account My Ryanair?	Che vantaggi ci sono nell'avere un account?	True
Come posso accedere agli aggiornamenti software e quanto tempo richiedono?	Come si aggiorna il software e in quanto tempo?	True
Cosa sono i Messaggi Diretti?	Vorrei ulteriori informazioni sui messaggi diretti, come funzionano?	True
Posso parlare con qualcuno riguardo a Vendita su Amazon?	Posso parlare con un operatore riguardo a Vendita su Amazon?	True
Chi possiede le informazioni create dai dipendenti?	Da chi sono posseduti I dati inseriti dai dipendenti?	True
La mia organizzazione usa attualmente Workplace Premium. A quale piano migreremo?	Se si usa attualmente Workplace premium, a quale piano verremo spostati?	True
Come posso confermare la mia prenotazione?	Come si può confermare una prenotazione?	True
Come posso avere un contatto per la mia prenotazione Rooms Direct?	A chi devo rivolgermi per gestire la prenotazione Rooms Direct?	True
Che cos’è un posto con 'vista limitata'?	In cosa consiste la frenata d'emergenza automatica?	False
I nuovi piani dove possono essere utilizzati?	Perchè devo registrare il mio tolino?	False
Quali sono le funzioni disponibili su Workplace che possono sostituire alcuni degli strumenti di lavoro esistenti della mia azienda?	Per gli interventi in garanzia devo riportare il mio veicolo Yamaha dallo stesso concessionario presso il quale l'ho acquistato?	False
Non mi è arrivata la mail di conferma, come faccio?	Potreste inviarmi di nuovo la email di conferma della registrazione?	True
Cos'è Vendita su Amazon?	Dove vengono inviati i biglietti?	False
Devo confermare ogni prenotazione?	Nel caso fossi un cliente subito per le imprese, quali dati dovrei fornire?	False
Come posso inserire i prodotto che devo vendere su Amazon?	Quando e dove devo fare la revisione del mio veicolo?	False
Come faccio a gestire gli ordini?	Come posso utilizzare dei codici sconto?	False
Ho fatto la registrazione. E ora?	Posso usare il computer in volo?	False
Sono previsti costi addizionali per i bambini?	Ci sono delle operazioni che devo effettuare prima di lasciare la mia moto ferma per molto tempo?	False
Posso utilizzare il coupon per acquistare qualsiasi oggetto?	Dove prendo più informazioni riguardo le funzionalità della mia Tesla?	False
Quanto costa la funzione per il lavoro frontline?	Cos'è coperto dall'assistenza stradale?	False
Perchè devo verificare il mio numero di telefono?	Perchè Subito continua a chiedermi il numero di telefono?	True
Qual'è la differenza tra Platea e Galleria?	In cosa differiscono Platea, Galleria, Balconata, ecc.?	True
Ho acquistato Workplace tramite un rivenditore partner. Quali sono le conseguenze per me?	Nel caso in cui io abbia acquistato Workplace da un rivenditore partner, quali potrebbero essere le conseguenze?	True
Chi posso contattare riguardo la mia prenotazione Rooms Direct?	Come posso avere un contatto per la mia prenotazione Rooms Direct?	True
Posso effettuare una prenotazione se non voglio iscrivermi?	Come posso prenotare se non voglio iscrivermi?	True
Quali sono i tempi di evasione dei testi prenotati?	Dopo quanto tempo viene spedito un ordine?	True
Come posso ottenere informazioni sulla camera o sui servizi della struttura?	Dove trovo informazioni riguardanti la camera e i servizi della struttura?	True
Cosa sono i limiti di follow?	Esiste un numero massimo di persone che posso seguire o che mi seguono?	True
Se non confermo una prenotazione?	Cosa sono i Messaggi Diretti?	False
A che ora devo presentarmi al punto di raccolta?	Quando devo trovarmi al punto di raccolta/incontro?	True
Quali sono i prodotti che vanno in categoria attrezzature di lavori?	Esiste una lista dettaglia degli articoli che possono essere inseriti in attrezzature da lavoro?	True
Quali sono le modalità di spedizione dei testi prenotati?	Come si utilizza il coupon?	False
Cosa posso vendere su Amazon.it?	Posso vendere prodotti di elettronica su Amazon?	True
Cosa succede quando un dipendente non lavora più nell'azienda?	Una volta terminato il periodo di lavoro di un dipendente, cosa succederà?	True
Perchè devo registrare il mio tolino?	Per quale motivo è necessaria la registrazione del mio tolino	True
Cosa è incluso nel prezzo che pago?	Cosa è incluso nel prezzo?	True
Quali sono i migliori posti?	Quali sono i posti migliori?	True
Come posso utilizzare dei codici sconto?	A che ora devo arrivare alla partita?	False
I miei dati verranno condivisi con qualcun altro?	I dati del mio account sono condivisi con terze parti?	True
Potete inviare un documento di conferma della cancellazione del volo per l'assicurazione?	Come ottengo un documento di conferma di cancellazione del volo?	True
Quanto costa vendere su Amazon?	Come si utilizza il coupon?	False
Che cosa succede se l’acquirente mi restituisce l’oggetto e io lo rimborso?	Come si attivano e usano i comandi vocali?	False
Perché Workplace passerà da due a tre piani per i prodotti?	Sono previsti sconti per bambini o studenti?	False
Vorrei modificare la password	È possibile cambiare la password?	True
Come posso confermare la mia prenotazione?	Il saldo rimanente di un voucher di viaggio può essere riutilizzato in un'altra prenotazione?	False
Come faccio ad ottenere una conferma di cancellazione della prenotzione?	Dove posso verificare se la mia prenotazione è stata cancellata?	True
Mi sono accorto che la mia carta d'identità è scaduta. Dove posso rinnovarla?	Dove posso rinnovare la carta d'identità scaduta?	True
È possibile arricchire la polizza includendo una condizione medica precedente?	È possibile includere nella polizza una condizione medica precedente?	True
Come posso inserire i prodotto che devo vendere su Amazon?	Non ricordo più la mia password dell'account.	False
Che tipo di foto devo caricare?	Va bene un immagine qualsiasi?	True
Quali sono i tempi di evasione dei testi prenotati?	Dove trovo le informazioni utili su tour e attrazioni?	False
Come ottengo un coupon?	Posso modificare un Tweet dopo averlo pubblicato?	False
Posso leggere sul mio tolino anche i vecchi acquisti?	Qual è il periodo di validità (prenotazione e viaggio) del mio voucher di viaggio? Ci sono limiti di data?	False
Perché ricevo un voucher di viaggio da Ryanair?	Per quale ragione Ryanair invia i voucher di viaggio?	True
Come si può confermare una prenotazione?	Le strutture prevedono l'accesso per sedie a rotelle o forniscono assistenza speciale?	False
Sono un cliente attuale di Workplace Standard. Quali sono le conseguenze per me?	Essendo io un cliente Workplace Standard, quali potrebbero essere le possibili conseguenze per me?	True
Come mi registro per vendere prodotti su Amazon.it?	Come mi iscrivo per vendere i miei prodotti su Amazon?	True
Posso effettuare una prenotazione se non voglio iscrivermi?	A che ora devo arrivare al mio punto di raccolta/incontro?	False
Quali sono i prodotti proibiti su Amazon.it?		True
Cosa significa seguire qualcuno su Twitter?	"A cosa serve il pulsante ""follow""?"	True
È possibile scegliere la copertina anche senza alcuna personalizzazione.	Come posso selezionare una copertina per il mio libro senza personalizzazioni?	True
Quali sono gli orari di check-in e di check-out della mia prenotazione alberghiera?	Dove posso consultare gli orari di check-in e check-out dell'albergo prenotato?	True
Posso guidare la mia auto durante un aggiornamento software?	Si può guidare l’auto mentre è in corso un aggiornamento software?	True
Cosa è incluso nel prezzo che pago?	Che servizi sono inclusi nel costo?	True
Posso offrire confezioni regalo ai miei clienti su Amazon?	Come faccio a prenotare i testi scolastici indicati dalla mia scuola?	False
Come devo comunicarvi il cambio di indirizzo?	Chi devo contattare per notificare il mio cambio di domicilio?	True
Posso cancellare la mia prenotazione?	Le attrazioni e i tour prevedono un dressing code?	False
Quando sarà online la mia struttura?	Non vedo il mio albergo sul sito. Quando sara' online?	True
Quali sono gli oggetti non consentiti nel bagaglio a mano?	Devo evitare di mettere alcuni oggetti nel bagaglio a mano?	True
Devo evitare di mettere alcuni oggetti nel bagaglio a mano?	Come posso ricevere una fattura?	False
Posso utilizzare più di un coupon alla volta?	Come posso utilizzare dei codici sconto?	False
Condividete i dati degli utenti con terze parti?	Come posso utilizzare dei codici sconto?	False
Chi esegue l'addebito sulla mia carta?	Come si passa attraverso le schermate del pannello strumenti di Model S e Model X?	False
Perché Workplace passerà da due a tre piani per i prodotti?	Quali sono le motivazioni per cui verrà aggiunto un piano per I prodotti?	True
I biglietti sono prenotati con il mio nome. Posso cambiare il nome del viaggiatore principale?	Posso cambiare il nome del viaggiatore principale una volta che ho prenotato a nome mio?	True
Posso scattare foto in un museo?	Quali funzioni hanno le manopole situate volante?	False
Posso offrire confezioni regalo ai miei clienti su Amazon?	Come pubblico una foto su Twitter?	False
Come posso dare accesso all’app ai miei famigliari?	Come posso inviarvi i miei consigli e suggerimenti?	False
C'è un limite al numero di biglietti che posso acquistare per una partita?	È previsto un limite di biglietti acquistabili per una partita?	True
Come posso aggiungere le copertine ai libri?	Posso continuare a inserire in categoria attrezzature di lavoro?	False
Cosa mi serve per iscrivermi come venditore su Amazon?	Come mi registro per vendere prodotti su Amazon.it?	True
Cosa non posso portare nel bagaglio da stiva?	Devo evitare di mettere alcuni oggetti nel bagaglio da stiva?	True
Qual è la definizione di dipendente frontline?	Dove posso trovare ulteriori informazioni sui Termini di Servizio di Twitter?	False
Cosa posso acquistare con le Gift Card Despar?	Cosa è possibile comprare con le Gift Card Despar?	True
Bisona avere PayPal per utilizzare il coupon?	Qual è la differenza tra i piani gratuiti e a pagamento?	False
Posso portare a bordo il personal computer?	Vorrei essere sicuro che una volta preparata la mia inserzione questa venga pubblicata subito, come posso fare?	False
In che modo Workplace protegge le mie informazioni?	Come le mie informazioni vengono protette da Workplace?	True
Posso fare foto o video all'interno di qualsiasi museo o attrazione?	Serve un  abbigliamento particolare per prendere parte ad un tour?	False
Posso cedere un coupon o utilizzare quello di qualcun altro?	I coupon sono cedibili?	True
Vuoi un suggerimento per evitare che il tuo annuncio venga rifiutato?	Possiamo inviarti dei consigli per fare si che la tua pubblicazione non venga rifiutata, li vuoi?	True
Quali sono i costi?	Mi imbarco per una destinazione internazionale. Quante valigie posso portare? Di che peso?	False
Come le mie informazioni vengono protette da Workplace?	Come scopro di più sulla Model 3?	False
I dati che ho inserito sono protetti?	Come si inseriscono nuovi contatti all’account utente?	False
Come posso ricevere i pagamenti?	Come faccio a ricevere i pagamenti?	True
Posso offrire confezioni regalo e biglietti di auguri ai miei clienti su Amazon.it?	Posso usare il computer in volo?	False
C'è un neonato incluso nella mia prenotazione annullata. Ha diritto a un voucher di viaggio?	Come pubblico una foto su Twitter?	False
Come posso ottenere una fattura per il mio soggiorno?	Come si ottiene una fattura per il soggiorno?	True
Che documenti necessita mio figlio minorenne per viaggiare?	Come posso sapere chi sto seguendo?	False
Sono previsti sconti particolari per studenti o determinate fascie d'età?	Come faccio a recuperare le chiavi in caso le perdessi?	False
Cosa sono le risposte?	Cosa sono i commenti ad un Tweet?	True
Come viene inviato il voucher regalo?	Come posso ricevere il voucher?	True
I dati del mio account sono condivisi con terze parti?	Condividete i dati degli utenti con terze parti?	True
Come posso utilizzare il mio Credito di Volo?	Cosa posso fare con il mio Credito di Volo?	True
Potete inviare un documento di conferma del ritardo del volo di più di 3 ore per l'assicurazione?	Come ottengo un documento di conferma di un ritardo?	True
A che ora devo arrivare al mio punto di raccolta/incontro?	A che ora devo presentarmi al punto di raccolta?	True
Si possono vendere medicinali su Amazon?	Quali sono i prodotti proibiti su Amazon.it?	True
C’è pubblicità su Workplace?	I miei biglietti sono validi solo per la fascia oraria prescelta?	False
Ho ricevuto un addebito nonostante non abbia ancora soggiornato.	C'è un limite al numero di biglietti che posso acquistare per una partita?	False
Come si utilizza il coupon?	Quali sono le motivazioni per cui verrà aggiunto un piano per I prodotti?	False
È possibile annullare un ordine anche se mi è già stato confermato via SMS?	Come passo da una schermata all'altra sul pannello strumenti di Model S e Model X?	False
Come risponde Workplace alle richieste di informazioni e dati sulla mia organizzazione o sui miei dipendenti da parte del governo o delle forze dell'ordine?	In cosa differiscono Platea, Galleria, Balconata, ecc.?	False
Come posso sapere chi mi sta seguendo?	È possibile ottenere la lista delle persone che ho iniziato a seguire?	True
A che ora devo presentarmi al punto di raccolta?	Perché non posso vedere tutti i miei Tweet? Sono stati persi?	False
Serve un  abbigliamento particolare per prendere parte ad un tour?	Come faccio a sapere la visibilità del mio annuncio nella ricerca?	False
Si puo' cambiare i dati?	Come posso trovare il numero di telaio e il codice identificativo del motore della mia Yamaha?	False
Ho sbagliato a digitare la mail e/o il numero di cellulare in fase di registrazione al sito	Dove posso rinnovare la carta d'identità scaduta?	False
Posso continuare a inserire in categoria attrezzature di lavoro?	È ancora consensito aggiungere inserzioni riguardo le attrezzature da lavoro?	True
Posso apportare modifiche alla mia prenotazione?	È possibile modificare una prenotazione?	True
I miei dati sono al sicuro?	I dati che ho inserito sono protetti?	True
Come posso confermare la mia prenotazione?	Come si conferma una prenotazione?	True
C’è pubblicità su Workplace?	Posso apportare modifiche alla mia prenotazione?	False
Ho sbagliato a digitare la mail e/o il numero di cellulare in fase di registrazione al sito	Come posso aggiungere l’opzione Homelink?	False
Posso annullare o cambiare le date di una prenotazione “non rimborsabile”?	"È possibile cancellare o modificare le date di una prenotazione ""non rimborsabile""?"	True
Dove posso usare i nuovi piani?	I nuovi piani dove possono essere utilizzati?	True
Come posso abilitare la modalità scura?	Come faccio ad attivare la Dark Mode?	True
Quali articoli posso vendere su Amazon.it?	Posso vendere prodotti di elettronica su Amazon?	True
Quali sono i termini temporali della copertura assicurativa?	Qual è la differenza tra Platea, Galleria, Balconata ecc.?	False
C'è un limite al numero di biglietti che posso acquistare per un tour o un’ attrazione?	Quanti biglietti per tour posso acquistare?	True
Come faccio a sapere se la mia prenotazione è stata cancellata?	Quali sono i regolamenti e il codice di condotta della sede?	False
In cosa consiste la modalià frontline di Workplace?	È possibile fare fotografie o video dovunque?	False
Che cos'è una cancellazione 'non rimborsabile' o 'cancellazione gratuita'?	Che differenza c'è tra cancellazione 'non rimborsabile' e 'cancellazione gratuita'?	True
Parto per gli Stati Uniti d'America. Che cos'è il programma Visa Waiver Program?	Posso cambiare le date della prenotazione?	False
Posso modificare un Tweet dopo averlo pubblicato?	È possibile apportare delle modifiche ad un Tweet dopo che è stato messo online?	True
Ho dimenticato la password	Come posso preventivare il costo di Workplace conoscendo il presso utente al mese?	False
Chi ha il monopolio delle informazioni inserite dai dipendenti della mia organizzazione?	Come funziona la frenata d'emergenza automatica?	False
Devo confermare ogni prenotazione?	Se non confermo una prenotazione?	True
Come ottengo un coupon?	Come si ottiene un coupon?	True
Come trovo delle persone da seguire?	Come posso contattare il servizio clienti Yamaha?	False
Come cancello una prenotazione?	In cosa differiscono Platea, Galleria, Balconata, ecc.?	False
Come si inseriscono nuovi contatti all’account utente?	Come si attiva l’opzione Summon?	False
A che ora bisogna arrivare per lo spettacolo?	Perché non riesco ad accedere all’app Tesla che mi è stata consegnata?	False
Perché non posso vedere tutti i miei Tweet? Sono stati persi?	Esiste un tempo limite oltre il quale i Tweet vengono cancellati automaticamente?	True
Il mio datore di lavoro può vedere il mio account Facebook personale?	Il mio account Facebook personale è visibile dal mio datore di lavoro?	True
È possibile utilizzare un portatile a bordo?	Posso usare un laptop sull'aereo?	True
Cos'è Twitter?	Ho sentito parlare di un social network chiamato Twitter, come funziona?	True
Che cosa si intende con “acquisto singolo” tra i requisiti per l’utilizzo di un coupon?	Posso usare il computer in volo?	False
Vorrei inviare un reclamo riguardo alla violazione del diritto d'autore su un contenuto protetto, come faccio?	Come devo comunicarvi il cambio di indirizzo?	False
Come si possono cambiare le date del mio prossimo viaggio?	Quali sono le principali differenze nella gestione della categoria attrezzature da lavoro?	False
Cos'è Vendita su Amazon?	A cosa serve Vendita su Amazon?	True
Posso vendere prodotti di elettronica su Amazon?	Sono diretto in un Paese della Comunità Europea. Che documento devo portare?	False
I miei dati verranno condivisi con qualcun altro?	Cos'è e come funziona la nuova Carta a Scalare?	False
Come si utilizza il coupon?	Come utilizzo il coupon?	True
È necessario iscriversi per ottenere un account?	Come faccio a recuperare le chiavi in caso le perdessi?	False
Chi ha il monopolio delle informazioni inserite dai dipendenti della mia organizzazione?	Quali sono gli orari di check-in e di check-out della mia prenotazione alberghiera?	False
Come faccio a sapere se la mia prenotazione è stata cancellata?	Come faccio ad ottenere una conferma di cancellazione della prenotzione?	True
Posso registrare o scattare foto all'interno di qualsiasi attrazione o museo?	Posso scattare foto in un museo?	True
Posso annullare o cambiare le date di una prenotazione “non rimborsabile”?	Posso cambiare le date della mia prenotazione se è 'non rimborsabile'?	True
Come mi registro come venditore su Amazon.it?	Come mi iscrivo per vendere i miei prodotti su Amazon?	True
Serve un  abbigliamento particolare per prendere parte ad un tour?	Come visualizzo il controllo energetico ?	False
Vi è disponibilità immediata sul mio tolino degli acquisti effettuati su LaFeltrinelli Internet Bookshop SRL?	Come si inseriscono nuovi contatti all’account utente?	False
È possibile arricchire la polizza includendo una condizione medica precedente?	E' possibile aggiungere coperutre addizionali alla polizza di assicurazione?	True
Come posso disattivare le persone non attive dal mio account Workplace Advanced o Enterprise?	A chi devo rivolgermi per gestire la prenotazione Rooms Direct?	False
Posso utilizzare un coupon in qualunque sito eBay o per oggetti in valute diverse?	Posso usare il cuoupon in un sito eBay di una nazione diversa?	True
È necessario creare un Adobe ID?	Un Adobe ID è necessario per poter usufruire del servizio?	True
Posso utilizzare il mio voucher di viaggio sull'applicazione Ryanair?	I voucher di viaggio possono essere utilizzati all'interno dell'app Ryanair?	True
Parto per un Paese che non appartiene alla Comunità Europea. Basta la carta d'identità ?	Servono ulteriori documenti per viaggiare in paesi non UE?	True
Come faccio a gestire gli ordini?	È consentito usare il laptop a bordo?	False
I miei biglietti sono validi solo per la fascia oraria prescelta?	Dove vengono inviati i biglietti?	False
I biglietti sono per i tifosi di casa o per quelli in trasferta?	I biglietti sono per i tifosi della squadra di casa o per gli ospiti?	True
A che ora devo recarmi nel luogo dello spettacolo?	Ho prenotato una fascia oraria, a che ora devo arrivare?	False
Posso cancellare il mio abbonamento?	A cosa servono le rotelline sul volante?	False
Cos'è un coupon?	La partecipazione alle partite è indicata per i bambini?	False
Posso leggere sul tolino i miei acquisti, effettuati altrove, di ebook protetti da Adobe DRM?	Gli ebook protetti da Adobe DRM acquistati altrove possono essere letti sul mio tolino?	True
I biglietti valgono soltanto durante la fascia oraria selezionata?	Desideri ricevere via email una lista di suggerimenti per migliorare il tuo annuncio?	False
È possibile aggiungere articoli ad un ordine che è già stato confermato?	Cosa posso fare se non trovo il campo per inserire il codice coupon presso un vendidtore?	False
Solo gli utenti eBay possono utilizzare coupon?	Il venditore accetta PayPal come metodo di pagamento.	False
Come viene inviato il voucher regalo?	In che maniera vengono inviati i voucher regalo?	True
Non mi è arrivata la mail di conferma, come faccio?	Dove posso portare a riparare l’auto?	False
In che tempistichesatanno disponibili I nuovi piani	I tour e le attrazioni sono adatti ai bambini?	False
Come faccio a sapere se i libri da me prenotati sono pronti per essere ritirati presso il punto vendita?	Essendo io un cliente Workplace Premium, quali potrebbero essere le possibili conseguenze per me?	False
Posso utilizzare il coupon per acquistare qualsiasi oggetto?	Come mi devo comportare se trovo una validatrice, a bordo mezzo o in stazione, guasta che non mi permette di effettuare la validazione?	False
A che ora devo recarmi nel luogo dello spettacolo?	Come faccio a segnalare lo spam?	False
I miei dati sono al sicuro?	Come sono variate le tariffe con l'introduzione del sistema MITT?	False
Cosa succede se un cliente non si presenta al check-in?	è possibile annullare il piano Workplace Premium?	False
Posso apportare modifiche alla mia prenotazione?	Come posso recuperare tutte le informazioni sui Termini di partecipazione a Twitter?	False
Cosa è incluso nell'acquisto?	Dove verifico cosa è incluso nell'acquisto?	True
Posso usare il cuoupon in un sito eBay di una nazione diversa?	Posso cambiare le date della prenotazione?	False
Che cosa succede se l'acquirente chiede un rimborso e ha pagato con un coupon?	Non ho utilizzato il valore totale del mio Voucher di Viaggio per la mia mia prenotazione. Posso utilizzare il saldo rimanente?	False
Esiste una mappa di navigazione per questo sito?	Esiste il rischio che qualcuno condivida contenuti dal suo account Facebook personale su Workplace?	False
Quanto costa la funzione per il lavoro frontline?	Qual è il costo per la funzione di lavoro frontline?	True
Avete una sicurezza di livello enterprise?	In che modo è possible trasferire ebook non procurati su LaFeltrinelli Internet Bookshop SRL?	False
Clicca qui per avere maggiori informazioni sui prezzi?	Posso pagare usando una carta diversa rispetto a quella della prenotazione?	False
Come faccio a gestire gli ordini?	Come vengono gestiti gli ordini?	True
Ci sono sconti per bambini o studenti?	Sono previsti sconti per bambini o studenti?	True
Cosa ottengo in cambio della commissione che pago?	Che servizio di preciso mi offre il sito?	True
Posso aggiornare in un secondo momento i dati forniti al momento della registrazione?	Si puo' cambiare i dati?	True
Come mi iscrivo per vendere i miei prodotti su Amazon?	Perchè Subito continua a chiedermi il numero di telefono?	False
Sono cardiopatico e indosso lo stimolatore cardiaco. Posso passare attraverso il metal detector?	È previsto un limite di biglietti acquistabili per una partita?	False
Quando inizia e quando finisce la mia copertura assicurativa?	Quali sono i termini temporali della copertura assicurativa?	True
Come scopro di più sulle funzioni della mia Tesla?	Dove prendo più informazioni riguardo le funzionalità della mia Tesla?	True
Come è calcolato il prezzo di una prenotazione?	Ho ricevuto un voucher di viaggio da Ryanair, ho ancora diritto alla compensazione EU261?	False
Come funziona lo sportello di ricarica?	Perché non posso vedere tutti i miei Tweet? Sono stati persi?	False
Posso utilizzare un coupon in qualunque sito eBay o per oggetti in valute diverse?	Quali documenti devo portare per viaggiare verso gli USA?	False
Posso annullare il mio piano Workplace Premium?	Su cosa si basa l’opzione di risparmio energetico?	False
Quali sono gli oggetti non consentiti nel bagaglio da stiva?	Cosa non posso portare nel bagaglio da stiva?	True
Ci sono costi in più per i bambini?	Sono previsti costi addizionali per i bambini?	True
Posso cambiare le date della prenotazione?	È possibile cambiare le date della prenotazione?	True
Che documenti necessita mio figlio minorenne per viaggiare?	Quali documenti sono necessari per viaggiare con un minore?	True
Come si crea un Adobe ID?	In che modo posso otenere un Adobe ID	True
Come faccio ad aggiungere un dipendente frontline a Workplace?	Come autorizzo l'accesso all'app alla mia famiglia?	False
Dove posso trovare gli acquisti effettuati?	Qual è la relazione tra il prezzo del biglietto e l'area in cui ci si siede?	False
Qual è la differenza tra Platea, Galleria, Balconata ecc.?	A che ora bisogna arrivare per lo spettacolo?	False
Come faccio a sapere se la mia prenotazione è stata cancellata?	Dove posso verificare se la mia prenotazione è stata cancellata?	True
Come posso ricevere i pagamenti?	La prenotazione può essere cancellata?	False
Quando devo pagare la quota di abbonamento?	Quali vantaggi fornisce un account My Ryanair?	False
Avete sistemi di protezione anti-frode?	Per quale ragione Ryanair invia i voucher di viaggio?	False
Cosa comporta l'impostazione di risparmio energetico?	Su cosa si basa l’opzione di risparmio energetico?	True
Quale metodo di spedizione viene utilizzato?	Posso apportare modifiche alla mia prenotazione?	False
Esiste una lista di negozi dove posso utilizzare la mia carta?	È possibile utilizzare un portatile a bordo?	False
In caso di ritardo, cosa devo fare per effettuare il check-in fuori dall'orario prestabilito?	Quali informazioni dovrei portare con me per entrare nell'attrazione?	False
Avete sistemi di protezione anti-frode?	Come vengo protetto dalle frodi?	True
Posso utilizzare un coupon insieme a un buono regalo per comprare un oggetto su eBay?	Coupon e Buoni Regalo sono cumulabili?	True
Qual è la definizione di dipendente frontline?	Come posso accendere e spegnere la mia auto?	False
Come posso ottenere una fattura per il mio soggiorno?	Come posso ricevere una fattura?	True
Quanto mi costa vendere su Amazon.it?		True
Come si naviga in questo sito?	Esiste una mappa di navigazione per questo sito?	True
Ho fatto la registrazione. E ora?	Il servizio di garanzia offerto da Yamaha copre anche gli interventi usuali di manutenzione?	False
Posso portare con me a bordo i miei medicinali? Necessito di un certificato medico?	La prenotazione può essere cancellata?	False
Quale è la procedura di uso per lo sportello di ricarica?	Gli interventi di manutenzione ordinaria sono coperti dalla garanzia?	False
Posso filmare lo spettacolo?	Lo spettacolo può essere registrato o fotografato?	True
Quale è il carico massimo consentito per il mio veicolo?	Quanto peso posso trasportare sulla mia moto se dovessi aggiungere dei bagagli?	True
Quanti biglietti per tour posso acquistare?	I tour e le attrazioni prevedono un numero massimo di biglietti acquistabili?	True
Ho sbagliato a digitare la mail e/o il numero di cellulare in fase di registrazione al sito	Cosa comporta avere un posto con 'vista limitata'?	False
I biglietti sono prenotati a mio nome. Posso cambiare il nome della persona che partecipa alla partita?	Posso modificare il nome in una prenotazione della partita effettuata a nome mio?	True
Che cosa faccio se l’indirizzo email associato al mio coupon è diverso da quello che uso per il conto PayPal?	Mi sono accorto che la mia carta d'identità è scaduta. Dove posso rinnovarla?	False
Posso cedere un coupon o utilizzare quello di qualcun altro?	é possibile condividere contenuti da un’account Facebook personale su Workplace?	False
Come invio un reclamo in materia di copyright, impersonificazione, marchi o altri problemi con i Termini di Servizio?	Vorrei inviare un reclamo riguardo alla violazione del diritto d'autore su un contenuto protetto, come faccio?	True
Come posso sapere se l’ordine è stato correttamente portato a termine?	Dove posso trovare le informazioni sullo stato dell'ordine?	True
Ho ricevuto un voucher di viaggio da Ryanair, ho ancora diritto alla compensazione EU261?	Ho diritto alla compensazione EU261, avendo ricevuto da Ryanair un voucher di viaggio?	True
Vorrei maggiori informazioni sulle Gift Card Despar.	Parto con un volo nazionale. Quante valigie posso portare? Di che peso?	False
Posso registrare o scattare foto all'interno di qualsiasi luogo?	È possibile fare fotografie o video dovunque?	True
Come cambiano le regole in attrezzature di lavoro?	Quali sono le principali differenze nella gestione della categoria attrezzature da lavoro?	True
Il costo di workplace verrà maggiorato iscrivendosi a Workplace premium?	Che cos'è una cancellazione 'non rimborsabile' o 'cancellazione gratuita'?	False
I tour e le attrazioni sono adatti ai bambini?	I tour e le attrazioni sono indicati per i bambini?	True
Non mi è arrivata la mail di conferma, come faccio?	Quali sono le caratteristiche dell’Autopilot e come si usa?	False
Solo gli utenti eBay possono utilizzare coupon?	"A cosa serve il pulsante ""follow""?"	False
Come posso sapere se l’ordine è stato correttamente portato a termine?	Perché non riesco ad accedere all'app Tesla dopo la consegna?	False
Posso aggiornare in un secondo momento i dati forniti al momento della registrazione?	I biglietti sono prenotati con il mio nome. Posso cambiare il nome del viaggiatore principale?	False
Cos'è il programma visa waiver? Cosa devo sapere di questo programma se parto per l'america?	Come si attiva l’opzione Summon?	False
Posso effettuare una prenotazione se non voglio iscrivermi?	Posso prenotare un volo senza iscrizione?	True
A che ora devo presentarmi alla partita?	Cosa succede in caso di cancellazione di una partita?	False
Ho subìto un ritardo e devo effettuare il check-in al di fuori dell’orario prestabilito, cosa devo fare?	Cosa succede se tento di salvare una ricerca, sarò in grado di poterla visualizzare più avanti?	False
Se non confermo una prenotazione?	Come si prosegue col no-show?	False
Quali articoli non posso vendere su Amazon.it?	Quante aziende usano Workplace?	False
Come funziona lo sportello di ricarica?	Quale è la procedura di uso per lo sportello di ricarica?	True
Sono presenti inserzioni su Workplace?	C’è pubblicità su Workplace?	True
A che ora devo arrivare per lo spettacolo?	A che ora bisogna arrivare per lo spettacolo?	True
Che vantaggi ci sono nell'avere un account?	Quali vantaggi fornisce un account My Ryanair?	True
I miei biglietti sono validi solo per la fascia oraria prescelta?	I biglietti sono validi solo per la fascia oraria prefissata?	True
Quali sono le funzioni disponibili su Workplace che possono sostituire alcuni degli strumenti di lavoro esistenti della mia azienda?	In che modo il servizio offerto da Workplace può modificare alcuni strumenti di lavoro già in utilizzo nella mia azienda?	True
Come pago la differenza tra il valore del coupon e il prezzo dell’oggetto?	Come posso pagare la differenza tra il coupon e il valore dell'acquisto?	True
Come utilizzo il coupon?	Mi sono accorto che la mia carta d'identità è scaduta. Dove posso rinnovarla?	False
Cosa succede in caso di cancellazione da parte dell'ospite?	Ho diritto alla compensazione EU261, avendo ricevuto da Ryanair un voucher di viaggio?	False
Posso cambiare le date della mia prenotazione se è 'non rimborsabile'?	Quanto vale il mio voucher di viaggio?	False
Ho prenotato una fascia oraria, a che ora devo arrivare?	Se prenoto una fascia oraria, quando devo arrivare?	True
C’è pubblicità su Workplace?	Come autorizzo l'accesso all'app alla mia famiglia?	False
Posso pagare usando una carta diversa rispetto a quella della prenotazione?	Che relazione c'è tra prezzo del biglietto e zona in cui si soggiorna?	False
Come posso essere certo che il mio annuncio venga pubblicato?	Come posso accedere agli aggiornamenti software e quanto tempo richiedono?	False
Il mio utente o la mia password sono errati, posso recuperarli?	Dove si legge il numero di telaio sulla mia auto Tesla?	False
Ho effettuato l'iscrizione a Workplace Premium. Il costo totale di Workplace aumenterà?	Il costo di workplace verrà maggiorato iscrivendosi a Workplace premium?	True
Come si prosegue col no-show?	Come posso selezionare una copertina per il mio libro senza personalizzazioni?	False
I biglietti hanno posti vicini?	I biglietti prevedono posti contigui?	True
Posso ricevere informazioni sulla camera da me prenotata?	"È possibile cancellare o modificare le date di una prenotazione ""non rimborsabile""?"	False
Se si usa attualmente Workplace premium, a quale piano verremo spostati?	Una volta modificato l'annuncio cosa succede?	False
Quali sono gli oggetti non consentiti nel bagaglio da stiva?	Devo evitare di mettere alcuni oggetti nel bagaglio da stiva?	True
Posso cancellare la mia prenotazione?	Come cancello una prenotazione?	True
Quali sono le motivazioni per cui verrà aggiunto un piano per I prodotti?	Quali documenti sono necessari per viaggiare con un minore?	False
Posso parlare con qualcuno riguardo a Vendita su Amazon?	Cosa posso fare se non trovo il campo per inserire il codice coupon presso un vendidtore?	False
Come riceverò i miei biglietti?	Dove vengono inviati i biglietti?	True
Cosa posso fare se non ho un account LaFeltrinelli Internet Bookshop SRL?	È possibile utilizzare dei codici o buoni sconto?	False
È possibile utilizzare un portatile a bordo?	Posso usare il computer in volo?	True
Parto con un volo nazionale. Quante valigie posso portare? Di che peso?	Cosa non posso portare nel bagaglio da stiva?	False
Come faccio ad aggiungere un dipendente frontline a Workplace?	Posso acquistare la vernice del colore del mio veicolo o conoscere il codice del colore?	False
Come posso sapere se l’ordine è stato correttamente portato a termine?	Mi verrà addebitato il pagamento se annullo la prenotazione?	False
Posso registrare o scattare foto all'interno di qualsiasi attrazione o museo?	Posso fare foto o video all'interno di qualsiasi museo o attrazione?	True
Come posso utilizzare dei codici sconto?	È possibile utilizzare dei codici o buoni sconto?	True
Come funzionano le Gift Card Despar?	Vorrei maggiori informazioni sulle Gift Card Despar.	True
Cosa succede se un cliente non si presenta al check-in?	Come si prosegue col no-show?	True
Quali posti sono considerati i migliori?	Quali sono i posti migliori?	True
Posso portare a bordo il personal computer?	Come configuro il mio profilo conducente?	False
Ho ricevuto un voucher di viaggio da Ryanair, Ho ancora diritto ad un rimborso o posso ancora riprenotare il mio volo annullato?	Ho diritto al rimboso o posso riprenotare un volo annullato dopo aver rivevuto il voucher di viaggio?	True
Posso acquistare la vernice del colore del mio veicolo o conoscere il codice del colore?	Come posso trovare l'identificatore del colore della moto che ho acquistato da voi?	True
Una volta passata a un piano diverso, la mia organizzazione perderà i dati presenti su Workplace?	Come faccio ad attivare la Dark Mode?	False
Potete inviare un documento di conferma del ritardo del volo di più di 3 ore per l'assicurazione?	Posso ottenere un documento di conferma del ritardo di più di 3 ore valido per fini assicurativi?	True
Esiste il rischio che qualcuno condivida contenuti dal suo account Facebook personale su Workplace?	Dove posso acquistare gli accessori per la mia Tesla?	False
Potete inviare un documento di conferma della cancellazione del volo per l'assicurazione?	È possibile ottenere un documento di conferma della cancellazione del volo per fini assicurativi?	True
Ho subìto un ritardo e devo effettuare il check-in al di fuori dell’orario prestabilito, cosa devo fare?	Il servizio di garanzia offerto da Yamaha copre anche gli interventi usuali di manutenzione?	False
Come passo da una schermata all'altra sul pannello strumenti di Model S e Model X?	Come si passa attraverso le schermate del pannello strumenti di Model S e Model X?	True
Posso effettuare una prenotazione se non voglio iscrivermi?	Vorrei contribuire a migliorare il sito, come faccio?	False
Per usufruire di Workplace serve un account Facebook?	Come posso ottenere una fattura per il mio soggiorno?	False
É possibile non ritirare un testo anche se ho già ricevuto l’sms/e-mail?	È possibile annullare un ordine anche se mi è già stato confermato via SMS?	True
Mi è arrivato un link tramite email, che cosa devo fare?	Ho ricevuto un link da subito nella mia casella di posta elettronica, come devo comportarmi?	True
Posso utilizzare più di un voucher di viaggio in una determinata prenotazione?	Posso usare diversi voucher di viaggio per la stessa prenotazione?	True
In che modo posso procedere per la rimozione del mio profilo?	Sono un cliente attuale di Workplace Premium. Quali sono le conseguenze per me?	False
Cosa succede al mio coupon se il pagamento viane stornato?	Perché Workplace passerà da due a tre piani per i prodotti?	False
Ci sono limiti di età per qualsiasi tour e attrazione?	Sono previsti limiti di età nei tour e attrazioni?	True
Dove posso trovare tutte le informazioni sul mio tour ed attrazione (ad es. Ora di inizio, durata, ecc.)?	Dove trovo le informazioni utili su tour e attrazioni?	True
Posso annullare il mio piano Workplace Premium?	è possibile annullare il piano Workplace Premium?	True
In che posizione si trova il mio annuncio?	Vorrei contribuire a migliorare il sito, come faccio?	False
Si puo' cambiare i dati?	Gli ebook protetti da Adobe DRM acquistati altrove possono essere letti sul mio tolino?	False
Una volta passata a un piano diverso, la mia organizzazione perderà i dati presenti su Workplace?	Dove posso reperire il codice del voucher dopo aver eliminato la mail ricevuta?	False
È richiesto un abbigliamento particolare per qualsiasi attrazione o tour?	Le attrazioni e i tour prevedono un dressing code?	True
Quale metodo di spedizione viene utilizzato?	Sono previsti limiti di età nei tour e attrazioni?	False
Con quali regole o limiti posso imbarcare il mio fucile e l'attrezzatura da caccia?	Dopo posso far riparare la mia auto?	False
Cosa succede in caso di cancellazione da parte dell'ospite?	Vorrei modificare la password	False
Dove verifico cosa è incluso nell'acquisto?	Cosa devo sapere sulla guida alle basse temperature?	False
Gli interventi di manutenzione ordinaria sono coperti dalla garanzia?	Il servizio di garanzia offerto da Yamaha copre anche gli interventi usuali di manutenzione?	True
Posso utilizzare il coupon per acquistare qualsiasi oggetto?	I coupon possono essere utilizzati su qualsiasi acquisto?	True
Una volta passata a un piano diverso, la mia organizzazione perderà i dati presenti su Workplace?	I dati presenti su workplace saranno disponibili anche dopo un cambio piano?	True
Come ci si può registrare?	Come può essere speso un voucher di viaggio?	False
Gli ospiti come possono pagare le prenotazioni?	Come si paga una prenotazione?	True
Quali sono i vantaggi per il venditore?	Come faccio a sapere se la mia prenotazione è stata cancellata?	False
Posso cambiare le date della prenotazione?	Come si possono cambiare le date del mio prossimo viaggio?	True
Cos'è un Tweet?	Vorrei sapere come funzionano i Tweet di Twitter.	True
Qual è la differenza tra Platea, Galleria, Balconata ecc.?	Qual'è la differenza tra Platea e Galleria?	True
Come ottengo un documento di conferma di cancellazione del volo?	È possibile ottenere un documento di conferma della cancellazione del volo per fini assicurativi?	True
Che documenti necessita mio figlio minorenne per viaggiare?	Quali documenti servono se ho un figlio minore di 18 anni?	True
Come posso pagare per utilizzare un coupon?	Come posso comportarmi nel caso in cui non avessi un accuout LaFeltrinelli Internet Bookshop SRL?	False
Come viene erogata assistenza medica in viaggio?	Cosa devo fare durante il volo se ho bisogno di assistenza medica?	True
Chi stabilisce il prezzo di vendita per la mia prenotazione?	Cosa posso fare se resto chiuso fuori dal veicolo?	False
Cosa mi serve per iscrivermi come venditore su Amazon?	Come mi registro come venditore su Amazon.it?	True
Cosa posso vendere su Amazon?	Posso vendere prodotti di elettronica su Amazon?	True
Devo avere un conto PayPal per utilizzare il coupon?	Bisona avere PayPal per utilizzare il coupon?	True
Che cosa succede se l’acquirente mi restituisce l’oggetto e io lo rimborso?	Che cosa succede se l'acquirente chiede un rimborso e ha pagato con un coupon?	True
Cos'è un ereader?	Se prenoto una fascia oraria, quando devo arrivare?	False
La prenotazione può essere cancellata?	Come posso trovare il numero di telaio e il codice identificativo del motore della mia Yamaha?	False
Dove trovo il numero di telaio della mia Tesla?	Dove si legge il numero di telaio sulla mia auto Tesla?	True
Come configuro il mio profilo conducente?	Come si configura il profilo del conducente sulla mia app?	True
Quali sono i vantaggi di un account My Ryanair?	Quale è la procedura di uso per lo sportello di ricarica?	False
A che ora bisogna arrivare per lo spettacolo?	A che ora devo recarmi nel luogo dello spettacolo?	True
Quali sono le motivazioni per cui verrà aggiunto un piano per I prodotti?	Chi legge i miei aggiornamenti?	False
Vorrei provare Workplace.	Dovrò effettuare l'accesso ogni volta che prenoto un volo?	False
Come ci si può registrare?	Come ci si registra?	True
A che ora devo arrivare al mio punto di raccolta/incontro?	Quando devo trovarmi al punto di raccolta/incontro?	True
Non riesco a trovare un libro che vorrei prenotare	Cos'è e come funziona la nuova Carta a Scalare?	False
Quando inizia e quando finisce la mia copertura assicurativa?	Per quanto tempo sono coperto dalla polizza assicurativa?	True
Posso pagare il mio soggiorno usando una carta diversa da quella utilizzata per la prenotazione?	È possibile pagare il soggiorno con una carta diversa da quella indicata nella prenotazione?	True
Ci sono costi aggiuntivi per i bambini?	Ci sono costi in più per i bambini?	True
Quando sarà online la mia struttura?	Cosa non posso portare nel bagaglio da stiva?	False
Come risponde Workplace alle richieste di informazioni e dati sulla mia organizzazione o sui miei dipendenti da parte del governo o delle forze dell'ordine?	Chi devo contattare per notificare il mio cambio di domicilio?	False
Come proteggo i miei dati personali?	Vorrei sapere come posso fare per evitare che i maleintenzionati si approprino dei miei dai sensibili.	True
Chi posso contattare in caso di problemi?	Come posso accendere e spegnere la mia auto?	False
Avete sistemi di protezione anti-frode?	Posso utilizzare il coupon per acquistare qualsiasi oggetto?	False
